Subj,SID,Trial,Resp,Response,ChooseLeft,RT,IssueLeft,IssueRight,PosLeft,PosRight,LeftSupport,LeftMoral,LeftFamiliar,Support_z.x,RightSupport,RightMoral,RightFamiliar,Support_z.y,LeftAdj,RightAdj,ChoiceSupport,ChoiceSupportNaive,ChoiceMoral,ChoiceSupportDist,ChoiceMoralDist,LeftAdjDiff,RightAdjDiff,LeftDiff_raw,ChooseRight,RTs
10,R_2Yxsaos59MLqKPE,1,j,2,0,11985.65999999852,Abolishing private prisons,Raise the minimum wage,-1,-1,3,4,2,1.9333873324249353,2,3,2,1.114155411905895,-3,-2,1,-1,-1,1,1,-1,1,1,1,11.98565999999852
10,R_2Yxsaos59MLqKPE,2,j,2,0,3941.145000000717,Build southern border wall,Mask mandates,1,1,-1,0,2,-1.3435403496512264,2,4,4,1.114155411905895,-1,2,3,3,4,3,4,-3,3,-3,1,3.9411450000007173
10,R_2Yxsaos59MLqKPE,3,j,2,0,4618.1299999988405,Mask mandates,Raise the minimum wage,1,1,2,4,4,1.114155411905895,2,3,2,1.114155411905895,2,2,0,0,-1,0,1,0,0,0,1,4.618129999998841
10,R_2Yxsaos59MLqKPE,4,f,1,1,2953.079999999376,Abortion rights,Ban on research with animals,1,-1,2,4,3,1.114155411905895,1,6,1,0.2949234913868545,2,-1,3,1,-2,3,2,3,-3,1,0,2.953079999999376
10,R_2Yxsaos59MLqKPE,5,j,2,0,4385.320000001229,Abolishing private prisons,Abolishing private prisons,-1,1,3,4,2,1.9333873324249353,3,4,2,1.9333873324249353,-3,3,6,0,0,6,0,-6,6,0,1,4.385320000001229
10,R_2Yxsaos59MLqKPE,6,j,2,0,7041.014999998966,Abortion rights,Abolishing private prisons,-1,1,2,4,3,1.114155411905895,3,4,2,1.9333873324249353,-2,3,5,1,0,5,0,-5,5,-1,1,7.041014999998966
10,R_2Yxsaos59MLqKPE,7,j,2,0,14197.560000000522,Abolishing private prisons,Bathrooms restricted based on biological sex,-1,1,3,4,2,1.9333873324249353,0,1,1,-0.524308429132186,-3,0,3,-3,-3,3,3,-3,3,3,1,14.197560000000522
10,R_2Yxsaos59MLqKPE,8,j,2,0,2505.909999999916,Ban on ethnic Halloween costumes,Abolishing private prisons,1,1,1,1,1,0.2949234913868545,3,4,2,1.9333873324249353,1,3,2,2,3,2,3,-2,2,-2,1,2.505909999999916
10,R_2Yxsaos59MLqKPE,9,f,1,1,7539.130000001052,Abolishing fraternities,Cuts to National Parks budget,-1,1,2,4,1,1.114155411905895,-1,2,1,-1.3435403496512264,-2,-1,-1,3,2,1,2,-1,1,3,0,7.539130000001053
10,R_2Yxsaos59MLqKPE,10,j,2,0,2920.739999997779,Abolishing private prisons,Abortion rights,-1,1,3,4,2,1.9333873324249353,2,4,3,1.114155411905895,-3,2,5,-1,0,5,0,-5,5,1,1,2.920739999997779
10,R_2Yxsaos59MLqKPE,11,j,2,0,2710.4749999998603,Abortion rights,Stop police brutality,-1,1,2,4,3,1.114155411905895,2,5,2,1.114155411905895,-2,2,4,0,1,4,1,-4,4,0,1,2.7104749999998603
10,R_2Yxsaos59MLqKPE,12,f,1,1,2616.1050000009127,Abolishing fraternities,Bathrooms restricted based on biological sex,1,1,2,4,1,1.114155411905895,0,1,1,-0.524308429132186,2,0,2,2,3,2,3,2,-2,2,0,2.6161050000009127
10,R_2Yxsaos59MLqKPE,13,j,2,0,2386.3799999998882,Stop police brutality,Ban on ethnic Halloween costumes,-1,1,2,5,2,1.114155411905895,1,1,1,0.2949234913868545,-2,1,3,-1,-4,3,4,-3,3,1,1,2.386379999999888
10,R_2Yxsaos59MLqKPE,14,f,1,1,7272.8399999977555,Mask mandates,Lift COVID lockdowns,-1,1,2,4,4,1.114155411905895,-1,3,2,-1.3435403496512264,-2,-1,-1,3,1,1,1,-1,1,3,0,7.272839999997755
10,R_2Yxsaos59MLqKPE,15,j,2,0,4127.9950000025565,Abolishing private prisons,Build southern border wall,-1,-1,3,4,2,1.9333873324249353,-1,0,2,-1.3435403496512264,-3,1,4,-4,-4,4,4,-4,4,4,1,4.1279950000025565
10,R_2Yxsaos59MLqKPE,16,j,2,0,3182.085000000312,Abolishing private prisons,Affirmative action,-1,1,3,4,2,1.9333873324249353,1,4,1,0.2949234913868545,-3,1,4,-2,0,4,0,-4,4,2,1,3.182085000000312
10,R_2Yxsaos59MLqKPE,17,j,2,0,5531.914999999572,Build southern border wall,Abolishing private prisons,-1,1,-1,0,2,-1.3435403496512264,3,4,2,1.9333873324249353,1,3,2,4,4,2,4,-2,2,-4,1,5.531914999999572
10,R_2Yxsaos59MLqKPE,18,j,2,0,2322.6900000008754,Abolishing private prisons,Raise the minimum wage,-1,1,3,4,2,1.9333873324249353,2,3,2,1.114155411905895,-3,2,5,-1,-1,5,1,-5,5,1,1,2.3226900000008754
10,R_2Yxsaos59MLqKPE,19,j,2,0,3718.095000000205,Increased Gun regulations,Abolishing private prisons,-1,1,0,3,3,-0.524308429132186,3,4,2,1.9333873324249353,-0,3,3,3,1,3,1,-3,3,-3,1,3.718095000000205
10,R_2Yxsaos59MLqKPE,20,f,1,1,2045.945000001695,Abortion rights,Increased Gun regulations,1,1,2,4,3,1.114155411905895,0,3,3,-0.524308429132186,2,0,2,2,1,2,1,2,-2,2,0,2.045945000001695
10,R_2Yxsaos59MLqKPE,21,f,1,1,3275.2049999980954,Stop police brutality,Expel students with white nationlist views,1,-1,2,5,2,1.114155411905895,-1,3,1,-1.3435403496512264,2,1,1,3,2,1,2,1,-1,3,0,3.2752049999980954
10,R_2Yxsaos59MLqKPE,22,f,1,1,9121.100000000326,Physician-assisted suicide,Abolishing private prisons,-1,-1,1,4,2,0.2949234913868545,3,4,2,1.9333873324249353,-1,-3,2,-2,0,2,0,2,-2,-2,0,9.121100000000325
10,R_2Yxsaos59MLqKPE,23,f,1,1,11913.964999999735,Stop police brutality,Abortion rights,-1,-1,2,5,2,1.114155411905895,2,4,3,1.114155411905895,-2,-2,0,0,1,0,1,0,0,0,0,11.913964999999735
10,R_2Yxsaos59MLqKPE,24,j,2,0,3134.654999998049,Ban on ethnic Halloween costumes,Abolishing fraternities,-1,1,1,1,1,0.2949234913868545,2,4,1,1.114155411905895,-1,2,3,1,3,3,3,-3,3,-1,1,3.134654999998049
10,R_2Yxsaos59MLqKPE,25,j,2,0,2431.904999997583,Abolishing private prisons,Legalization of marijuana,-1,-1,3,4,2,1.9333873324249353,1,3,3,0.2949234913868545,-3,-1,2,-2,-1,2,1,-2,2,2,1,2.4319049999975832
10,R_2Yxsaos59MLqKPE,26,f,1,1,2065.370000000228,Ban on research with animals,Abolishing private prisons,1,-1,1,6,1,0.2949234913868545,3,4,2,1.9333873324249353,1,-3,4,-2,2,4,2,4,-4,-2,0,2.065370000000228
10,R_2Yxsaos59MLqKPE,27,j,2,0,8900.24500000081,Abolishing private prisons,Increased Gun regulations,-1,1,3,4,2,1.9333873324249353,0,3,3,-0.524308429132186,-3,0,3,-3,-1,3,1,-3,3,3,1,8.90024500000081
10,R_2Yxsaos59MLqKPE,28,j,2,0,2424.5799999989104,Abolishing private prisons,Ban on ethnic Halloween costumes,-1,1,3,4,2,1.9333873324249353,1,1,1,0.2949234913868545,-3,1,4,-2,-3,4,3,-4,4,2,1,2.4245799999989104
10,R_2Yxsaos59MLqKPE,29,j,2,0,2290.304999998538,Ban on ethnic Halloween costumes,Abolishing private prisons,-1,1,1,1,1,0.2949234913868545,3,4,2,1.9333873324249353,-1,3,4,2,3,4,3,-4,4,-2,1,2.2903049999985376
10,R_2Yxsaos59MLqKPE,30,j,2,0,3250.7650000007125,Abolishing fraternities,Ban on ethnic Halloween costumes,-1,-1,2,4,1,1.114155411905895,1,1,1,0.2949234913868545,-2,-1,1,-1,-3,1,3,-1,1,1,1,3.2507650000007127
10,R_2Yxsaos59MLqKPE,31,f,1,1,4965.384999999427,Mask mandates,Black Lives Matter,-1,-1,2,4,4,1.114155411905895,1,4,2,0.2949234913868545,-2,-1,-1,1,0,1,0,-1,1,1,0,4.9653849999994275
10,R_2Yxsaos59MLqKPE,32,f,1,1,2017.8299999970477,Stop police brutality,Ban on research with animals,1,-1,2,5,2,1.114155411905895,1,6,1,0.2949234913868545,2,-1,3,1,-1,3,1,3,-3,1,0,2.0178299999970477
10,R_2Yxsaos59MLqKPE,33,j,2,0,1596.5250000008382,Stop police brutality,Stop police brutality,-1,1,2,5,2,1.114155411905895,2,5,2,1.114155411905895,-2,2,4,0,0,4,0,-4,4,0,1,1.5965250000008382
10,R_2Yxsaos59MLqKPE,34,j,2,0,6293.144999999669,Build southern border wall,Mask mandates,1,-1,-1,0,2,-1.3435403496512264,2,4,4,1.114155411905895,-1,-2,-1,3,4,1,4,1,-1,-3,1,6.29314499999967
10,R_2Yxsaos59MLqKPE,35,j,2,0,1799.8049999986542,Build southern border wall,Stop police brutality,1,1,-1,0,2,-1.3435403496512264,2,5,2,1.114155411905895,-1,2,3,3,5,3,5,-3,3,-3,1,1.7998049999986543
10,R_2Yxsaos59MLqKPE,36,j,2,0,2874.5650000018068,Remove Christopher Columbus statues,Abolishing private prisons,1,1,-1,2,1,-1.3435403496512264,3,4,2,1.9333873324249353,-1,3,4,4,2,4,2,-4,4,-4,1,2.8745650000018066
10,R_2Yxsaos59MLqKPE,37,j,2,0,2070.0700000015786,Physician-assisted suicide,Stop police brutality,-1,1,1,4,2,0.2949234913868545,2,5,2,1.114155411905895,-1,2,3,1,1,3,1,-3,3,-1,1,2.0700700000015786
10,R_2Yxsaos59MLqKPE,38,j,2,0,2020.7399999998743,Raise the minimum wage,Abolishing private prisons,-1,1,2,3,2,1.114155411905895,3,4,2,1.9333873324249353,-2,3,5,1,1,5,1,-5,5,-1,1,2.0207399999998743
10,R_2Yxsaos59MLqKPE,39,j,2,0,2904.230000000214,Detention of migrant children,Abolishing private prisons,-1,1,-1,4,1,-1.3435403496512264,3,4,2,1.9333873324249353,1,3,2,4,0,2,0,-2,2,-4,1,2.904230000000214
10,R_2Yxsaos59MLqKPE,40,f,1,1,6045.704999996815,Build southern border wall,Abolishing private prisons,1,-1,-1,0,2,-1.3435403496512264,3,4,2,1.9333873324249353,-1,-3,2,-4,-4,2,4,2,-2,-4,0,6.045704999996815
10,R_2Yxsaos59MLqKPE,41,j,2,0,2960.975000001723,Build southern border wall,Stop police brutality,-1,1,-1,0,2,-1.3435403496512264,2,5,2,1.114155411905895,1,2,1,3,5,1,5,-1,1,-3,1,2.960975000001723
10,R_2Yxsaos59MLqKPE,42,f,1,1,3384.7399999976624,Raise the minimum wage,Stop police brutality,-1,-1,2,3,2,1.114155411905895,2,5,2,1.114155411905895,-2,-2,0,0,-2,0,2,0,0,0,0,3.384739999997662
10,R_2Yxsaos59MLqKPE,43,f,1,1,2565.934999998659,Abortion rights,Build southern border wall,1,-1,2,4,3,1.114155411905895,-1,0,2,-1.3435403496512264,2,1,1,3,4,1,4,1,-1,3,0,2.565934999998659
10,R_2Yxsaos59MLqKPE,44,f,1,1,12234.984999999171,Abolishing private prisons,Ban on research with animals,1,1,3,4,2,1.9333873324249353,1,6,1,0.2949234913868545,3,1,2,2,-2,2,2,2,-2,2,0,12.23498499999917
10,R_2Yxsaos59MLqKPE,45,f,1,1,7688.109999999171,Ban on research with animals,Abolishing private prisons,-1,-1,1,6,1,0.2949234913868545,3,4,2,1.9333873324249353,-1,-3,2,-2,2,2,2,2,-2,-2,0,7.688109999999171
10,R_2Yxsaos59MLqKPE,46,j,2,0,4432.015000002226,Mask mandates,Cuts to National Parks budget,1,1,2,4,4,1.114155411905895,-1,2,1,-1.3435403496512264,2,-1,-3,-3,-2,3,2,3,-3,3,1,4.432015000002226
10,R_2Yxsaos59MLqKPE,47,f,1,1,4223.659999999683,Cuts to National Parks budget,Abolishing private prisons,1,-1,-1,2,1,-1.3435403496512264,3,4,2,1.9333873324249353,-1,-3,2,-4,-2,2,2,2,-2,-4,0,4.2236599999996836
10,R_2Yxsaos59MLqKPE,48,f,1,1,2314.1599999980535,Abolishing fraternities,Ban on ethnic Halloween costumes,1,1,2,4,1,1.114155411905895,1,1,1,0.2949234913868545,2,1,1,1,3,1,3,1,-1,1,0,2.3141599999980533
10,R_2Yxsaos59MLqKPE,49,j,2,0,1369.7299999985844,Cuts to National Parks budget,Abortion rights,-1,1,-1,2,1,-1.3435403496512264,2,4,3,1.114155411905895,1,2,1,3,2,1,2,-1,1,-3,1,1.3697299999985844
10,R_2Yxsaos59MLqKPE,50,f,1,1,2402.409999998752,Abolishing private prisons,Bathrooms restricted based on biological sex,1,1,3,4,2,1.9333873324249353,0,1,1,-0.524308429132186,3,0,3,3,3,3,3,3,-3,3,0,2.402409999998752
10,R_2Yxsaos59MLqKPE,51,j,2,0,2827.744999998715,Abortion rights,Cuts to National Parks budget,-1,-1,2,4,3,1.114155411905895,-1,2,1,-1.3435403496512264,-2,1,3,-3,-2,3,2,-3,3,3,1,2.827744999998715
10,R_2Yxsaos59MLqKPE,52,f,1,1,2328.1499999975786,Mask mandates,Lift COVID lockdowns,1,-1,2,4,4,1.114155411905895,-1,3,2,-1.3435403496512264,2,1,1,3,1,1,1,1,-1,3,0,2.3281499999975788
10,R_2Yxsaos59MLqKPE,53,j,2,0,2187.874999999767,Abolishing private prisons,Ban on ethnic Halloween costumes,-1,-1,3,4,2,1.9333873324249353,1,1,1,0.2949234913868545,-3,-1,2,-2,-3,2,3,-2,2,2,1,2.1878749999997673
10,R_2Yxsaos59MLqKPE,54,j,2,0,2110.9800000013784,Stop police brutality,Abolishing private prisons,-1,1,2,5,2,1.114155411905895,3,4,2,1.9333873324249353,-2,3,5,1,-1,5,1,-5,5,-1,1,2.1109800000013785
10,R_2Yxsaos59MLqKPE,55,f,1,1,3710.890000001993,Expel students with white nationlist views,Stop police brutality,-1,-1,-1,3,1,-1.3435403496512264,2,5,2,1.114155411905895,1,-2,3,-3,-2,3,2,3,-3,-3,0,3.710890000001993
10,R_2Yxsaos59MLqKPE,56,f,1,1,2047.0999999998603,Raise the minimum wage,Mask mandates,1,-1,2,3,2,1.114155411905895,2,4,4,1.114155411905895,2,-2,4,0,-1,4,1,4,-4,0,0,2.0470999999998605
10,R_2Yxsaos59MLqKPE,57,j,2,0,1724.8849999995437,Raise the minimum wage,Stop police brutality,1,1,2,3,2,1.114155411905895,2,5,2,1.114155411905895,2,2,0,0,2,0,2,0,0,0,1,1.7248849999995437
10,R_2Yxsaos59MLqKPE,58,f,1,1,3686.480000000214,Abolishing fraternities,Abolishing private prisons,-1,-1,2,4,1,1.114155411905895,3,4,2,1.9333873324249353,-2,-3,1,-1,0,1,0,1,-1,-1,0,3.686480000000214
10,R_2Yxsaos59MLqKPE,59,j,2,0,1627.4750000012573,Increased Gun regulations,Stop police brutality,1,1,0,3,3,-0.524308429132186,2,5,2,1.114155411905895,0,2,2,2,2,2,2,-2,2,-2,1,1.6274750000012572
10,R_2Yxsaos59MLqKPE,60,f,1,1,3960.3249999999534,Mask mandates,Mandatory vaccinations,-1,-1,2,4,4,1.114155411905895,-1,4,2,-1.3435403496512264,-2,1,-3,3,0,3,0,-3,3,3,0,3.9603249999999535
10,R_2Yxsaos59MLqKPE,61,f,1,1,3645.6599999982864,Ban on research with animals,Mask mandates,1,1,1,6,1,0.2949234913868545,2,4,4,1.114155411905895,1,2,-1,-1,2,1,2,-1,1,-1,0,3.645659999998286
10,R_2Yxsaos59MLqKPE,62,f,1,1,1129.9450000005309,Abortion rights,Stop police brutality,1,-1,2,4,3,1.114155411905895,2,5,2,1.114155411905895,2,-2,4,0,-1,4,1,4,-4,0,0,1.1299450000005309
10,R_2Yxsaos59MLqKPE,63,f,1,1,5089.915000000503,Abolishing private prisons,Stop police brutality,1,1,3,4,2,1.9333873324249353,2,5,2,1.114155411905895,3,2,1,1,-1,1,1,1,-1,1,0,5.089915000000503
10,R_2Yxsaos59MLqKPE,64,j,2,0,3552.379999997327,Bathrooms restricted based on biological sex,Mask mandates,-1,-1,0,1,1,-0.524308429132186,2,4,4,1.114155411905895,-0,-2,-2,2,3,2,3,2,-2,-2,1,3.552379999997327
10,R_2Yxsaos59MLqKPE,65,f,1,1,1663.1649999981746,Stop police brutality,Bathrooms restricted based on biological sex,1,1,2,5,2,1.114155411905895,0,1,1,-0.524308429132186,2,0,2,2,4,2,4,2,-2,2,0,1.6631649999981746
10,R_2Yxsaos59MLqKPE,66,j,2,0,1900.779999999795,War on Drugs,Stop police brutality,-1,1,1,3,2,0.2949234913868545,2,5,2,1.114155411905895,-1,2,3,1,2,3,2,-3,3,-1,1,1.9007799999997952
10,R_2Yxsaos59MLqKPE,67,j,2,0,3617.1199999991804,Stop police brutality,Ban on research with animals,1,1,2,5,2,1.114155411905895,1,6,1,0.2949234913868545,2,1,-1,-1,1,1,1,1,-1,1,1,3.6171199999991805
10,R_2Yxsaos59MLqKPE,68,j,2,0,2269.799999998184,"Boycott, Divest, and Sanction Israel",Stop police brutality,1,1,1,4,1,0.2949234913868545,2,5,2,1.114155411905895,1,2,1,1,1,1,1,-1,1,-1,1,2.2697999999981837
10,R_2Yxsaos59MLqKPE,69,j,2,0,3898.399999998277,Ban on research with animals,Abolishing fraternities,-1,-1,1,6,1,0.2949234913868545,2,4,1,1.114155411905895,-1,-2,-1,1,-2,1,2,1,-1,-1,1,3.898399999998277
10,R_2Yxsaos59MLqKPE,70,f,1,1,2794.7799999965355,Abolishing private prisons,Legalization of marijuana,1,-1,3,4,2,1.9333873324249353,1,3,3,0.2949234913868545,3,-1,4,2,1,4,1,4,-4,2,0,2.7947799999965355
10,R_2Yxsaos59MLqKPE,71,j,2,0,1522.1950000012293,Lift COVID lockdowns,Abortion rights,1,1,-1,3,2,-1.3435403496512264,2,4,3,1.114155411905895,-1,2,3,3,1,3,1,-3,3,-3,1,1.5221950000012294
10,R_2Yxsaos59MLqKPE,72,j,2,0,2031.6700000003912,Abortion rights,Raise the minimum wage,-1,-1,2,4,3,1.114155411905895,2,3,2,1.114155411905895,-2,-2,0,0,-1,0,1,0,0,0,1,2.0316700000003913
10,R_2Yxsaos59MLqKPE,73,f,1,1,1783.029999998631,Abolishing private prisons,Mask mandates,1,1,3,4,2,1.9333873324249353,2,4,4,1.114155411905895,3,2,1,1,0,1,0,1,-1,1,0,1.783029999998631
10,R_2Yxsaos59MLqKPE,74,j,2,0,3087.260000000242,Abortion rights,Ban on research with animals,-1,1,2,4,3,1.114155411905895,1,6,1,0.2949234913868545,-2,1,3,-1,2,3,2,-3,3,1,1,3.087260000000242
10,R_2Yxsaos59MLqKPE,75,f,1,1,5466.89499999769,Abolishing fraternities,Increased Gun regulations,-1,1,2,4,1,1.114155411905895,0,3,3,-0.524308429132186,-2,0,-2,2,1,2,1,-2,2,2,0,5.46689499999769
10,R_2Yxsaos59MLqKPE,76,j,2,0,4569.425000001444,Mandatory vaccinations,Mask mandates,-1,1,-1,4,2,-1.3435403496512264,2,4,4,1.114155411905895,1,2,1,3,0,1,0,-1,1,-3,1,4.569425000001443
10,R_2Yxsaos59MLqKPE,77,j,2,0,2369.634999999078,Raise the minimum wage,Mask mandates,-1,1,2,3,2,1.114155411905895,2,4,4,1.114155411905895,-2,2,4,0,1,4,1,-4,4,0,1,2.369634999999078
10,R_2Yxsaos59MLqKPE,78,f,1,1,3191.275000001071,Gun-free campus police,Abolishing fraternities,1,-1,1,3,1,0.2949234913868545,2,4,1,1.114155411905895,1,-2,3,-1,-1,3,1,3,-3,-1,0,3.1912750000010712
10,R_2Yxsaos59MLqKPE,79,j,2,0,3603.5699999993667,Abolishing private prisons,Stop police brutality,-1,-1,3,4,2,1.9333873324249353,2,5,2,1.114155411905895,-3,-2,1,-1,1,1,1,-1,1,1,1,3.6035699999993667
10,R_2Yxsaos59MLqKPE,80,j,2,0,2250.985000002198,Ban on research with animals,Abolishing private prisons,-1,1,1,6,1,0.2949234913868545,3,4,2,1.9333873324249353,-1,3,4,2,-2,4,2,-4,4,-2,1,2.250985000002198
10,R_2Yxsaos59MLqKPE,81,f,1,1,2985.8399999975227,Ban on ethnic Halloween costumes,Mask mandates,1,-1,1,1,1,0.2949234913868545,2,4,4,1.114155411905895,1,-2,3,-1,-3,3,3,3,-3,-1,0,2.9858399999975225
10,R_2Yxsaos59MLqKPE,82,f,1,1,1608.7850000003818,Stop police brutality,Abolishing private prisons,1,-1,2,5,2,1.114155411905895,3,4,2,1.9333873324249353,2,-3,5,-1,1,5,1,5,-5,-1,0,1.6087850000003818
10,R_2Yxsaos59MLqKPE,83,j,2,0,3808.3600000026636,Abolishing fraternities,Stop police brutality,1,1,2,4,1,1.114155411905895,2,5,2,1.114155411905895,2,2,0,0,1,0,1,0,0,0,1,3.8083600000026636
10,R_2Yxsaos59MLqKPE,84,j,2,0,2710.4949999994133,Abolishing fraternities,Build southern border wall,-1,-1,2,4,1,1.114155411905895,-1,0,2,-1.3435403496512264,-2,1,3,-3,-4,3,4,-3,3,3,1,2.7104949999994132
10,R_2Yxsaos59MLqKPE,85,f,1,1,1676.3199999986682,Abolishing private prisons,Cuts to National Parks budget,1,-1,3,4,2,1.9333873324249353,-1,2,1,-1.3435403496512264,3,1,2,4,2,2,2,2,-2,4,0,1.6763199999986682
10,R_2Yxsaos59MLqKPE,86,j,2,0,1664.0050000024494,Expel students with white nationlist views,Abolishing private prisons,-1,1,-1,3,1,-1.3435403496512264,3,4,2,1.9333873324249353,1,3,2,4,1,2,1,-2,2,-4,1,1.6640050000024493
10,R_2Yxsaos59MLqKPE,87,f,1,1,2667.385000000708,Mask mandates,Abolishing fraternities,1,-1,2,4,4,1.114155411905895,2,4,1,1.114155411905895,2,-2,4,0,0,4,0,4,-4,0,0,2.6673850000007078
10,R_2Yxsaos59MLqKPE,88,f,1,1,2524.570000001462,Abolishing fraternities,Mandatory vaccinations,1,1,2,4,1,1.114155411905895,-1,4,2,-1.3435403496512264,2,-1,3,3,0,3,0,3,-3,3,0,2.524570000001462
10,R_2Yxsaos59MLqKPE,89,f,1,1,1639.9899999997579,Stop police brutality,Ban on ethnic Halloween costumes,1,1,2,5,2,1.114155411905895,1,1,1,0.2949234913868545,2,1,1,1,4,1,4,1,-1,1,0,1.6399899999997578
10,R_2Yxsaos59MLqKPE,90,f,1,1,1598.8400000021793,Stop police brutality,Remove Christopher Columbus statues,1,-1,2,5,2,1.114155411905895,-1,2,1,-1.3435403496512264,2,1,1,3,3,1,3,1,-1,3,0,1.5988400000021792
10,R_2Yxsaos59MLqKPE,91,j,2,0,1377.7200000004377,Remove public Confederate memorials,Abolishing private prisons,-1,1,1,4,1,0.2949234913868545,3,4,2,1.9333873324249353,-1,3,4,2,0,4,0,-4,4,-2,1,1.3777200000004377
10,R_2Yxsaos59MLqKPE,92,j,2,0,2035.8549999983516,Stop police brutality,Raise the minimum wage,-1,1,2,5,2,1.114155411905895,2,3,2,1.114155411905895,-2,2,4,0,-2,4,2,-4,4,0,1,2.0358549999983517
10,R_2Yxsaos59MLqKPE,93,j,2,0,1546.994999997085,Remove Christopher Columbus statues,Stop police brutality,1,1,-1,2,1,-1.3435403496512264,2,5,2,1.114155411905895,-1,2,3,3,3,3,3,-3,3,-3,1,1.546994999997085
10,R_2Yxsaos59MLqKPE,94,f,1,1,2087.769999998389,Gun-free campus police,Abolishing private prisons,1,-1,1,3,1,0.2949234913868545,3,4,2,1.9333873324249353,1,-3,4,-2,-1,4,1,4,-4,-2,0,2.0877699999983887
10,R_2Yxsaos59MLqKPE,95,f,1,1,1414.4100000010803,Stop police brutality,Raise the minimum wage,1,-1,2,5,2,1.114155411905895,2,3,2,1.114155411905895,2,-2,4,0,2,4,2,4,-4,0,0,1.4144100000010804
10,R_2Yxsaos59MLqKPE,96,j,2,0,3925.139999999432,Stop police brutality,Gun-free campus police,-1,-1,2,5,2,1.114155411905895,1,3,1,0.2949234913868545,-2,-1,1,-1,-2,1,2,-1,1,1,1,3.925139999999432
10,R_2Yxsaos59MLqKPE,97,j,2,0,2334.7700000014156,Abolishing private prisons,Remove Christopher Columbus statues,-1,-1,3,4,2,1.9333873324249353,-1,2,1,-1.3435403496512264,-3,1,4,-4,-2,4,2,-4,4,4,1,2.3347700000014155
10,R_2Yxsaos59MLqKPE,98,f,1,1,1948.950000001816,Abolishing private prisons,Build southern border wall,1,1,3,4,2,1.9333873324249353,-1,0,2,-1.3435403496512264,3,-1,4,4,4,4,4,4,-4,4,0,1.948950000001816
10,R_2Yxsaos59MLqKPE,99,f,1,1,1741.6900000025053,Stop police brutality,Ban on ethnic Halloween costumes,1,-1,2,5,2,1.114155411905895,1,1,1,0.2949234913868545,2,-1,3,1,4,3,4,3,-3,1,0,1.7416900000025053
10,R_2Yxsaos59MLqKPE,100,j,2,0,1752.905000001192,Raise the minimum wage,Abolishing private prisons,1,1,2,3,2,1.114155411905895,3,4,2,1.9333873324249353,2,3,1,1,1,1,1,-1,1,-1,1,1.752905000001192
8,R_2tbPVD1DV0HLe3w,1,j,2,0,1432.1999999284744,Mandatory vaccinations,Ban on research with animals,1,-1,2,7,2,0.16666666666666682,3,5,3,1.023809523809524,2,-3,-5,1,-2,5,2,5,-5,-1,1,1.4321999999284745
8,R_2tbPVD1DV0HLe3w,2,j,2,0,3582.5,"Boycott, Divest, and Sanction Israel",Abolishing private prisons,1,1,3,5,3,1.023809523809524,3,6,3,1.023809523809524,3,3,0,0,1,0,1,0,0,0,1,3.5825
8,R_2tbPVD1DV0HLe3w,3,j,2,0,20010.5,Mandatory drug tests for welfare recipients,Ban on research with animals,-1,1,2,6,2,0.16666666666666682,3,5,3,1.023809523809524,-2,3,5,1,-1,5,1,-5,5,-1,1,20.0105
8,R_2tbPVD1DV0HLe3w,4,j,2,0,6690.900000095367,Mask mandates,Raise the minimum wage,1,-1,3,7,3,1.023809523809524,2,4,4,0.16666666666666682,3,-2,-5,-1,-3,5,3,5,-5,1,1,6.690900000095367
8,R_2tbPVD1DV0HLe3w,5,j,2,0,2268.2000000476837,Raise the minimum wage,Mask mandates,1,1,2,4,4,0.16666666666666682,3,7,3,1.023809523809524,2,3,1,1,3,1,3,-1,1,-1,1,2.268200000047684
8,R_2tbPVD1DV0HLe3w,6,j,2,0,4118.699999928474,Student worker unionization,Religious exemptions for discrimination laws,1,1,2,5,4,0.16666666666666682,3,5,3,1.023809523809524,2,3,1,1,0,1,0,-1,1,-1,1,4.118699999928475
8,R_2tbPVD1DV0HLe3w,7,j,2,0,3752.5,Affirmative action,U.S. drone strikes in Afghanistan,-1,1,3,7,3,1.023809523809524,2,6,2,0.16666666666666682,-3,2,5,-1,-1,5,1,-5,5,1,1,3.7525
8,R_2tbPVD1DV0HLe3w,8,j,2,0,2182.7000000476837,Mask mandates,Abolishing fraternities,1,-1,3,7,3,1.023809523809524,-1,5,3,-2.4047619047619047,3,1,-2,-4,-2,2,2,2,-2,4,1,2.1827000000476837
8,R_2tbPVD1DV0HLe3w,9,j,2,0,8248.600000023842,Hardening schools/Arming teachers,Increased Gun regulations,-1,1,3,6,3,1.023809523809524,1,5,3,-0.6904761904761902,-3,1,4,-2,-1,4,1,-4,4,2,1,8.248600000023842
8,R_2tbPVD1DV0HLe3w,10,j,2,0,3029.3000000715256,Tuition increases,Hardening schools/Arming teachers,-1,1,0,6,3,-1.5476190476190474,3,6,3,1.023809523809524,-0,3,3,3,0,3,0,-3,3,-3,1,3.0293000000715256
8,R_2tbPVD1DV0HLe3w,11,j,2,0,2267.2999999523163,Climate change legislation,Cuts to National Parks budget,1,1,3,6,3,1.023809523809524,2,7,2,0.16666666666666682,3,2,-1,-1,1,1,1,1,-1,1,1,2.2672999999523165
8,R_2tbPVD1DV0HLe3w,12,f,1,1,10956.899999976158,Abortion rights,Defund the police,1,1,3,5,3,1.023809523809524,2,7,2,0.16666666666666682,3,2,1,1,-2,1,2,1,-1,1,0,10.956899999976159
8,R_2tbPVD1DV0HLe3w,13,j,2,0,599.0999999046326,Hardening schools/Arming teachers,Raise the minimum wage,-1,-1,3,6,3,1.023809523809524,2,4,4,0.16666666666666682,-3,-2,1,-1,-2,1,2,-1,1,1,1,0.5990999999046326
8,R_2tbPVD1DV0HLe3w,14,f,1,1,1030.1000000238419,On campus concealed carry,"Boycott, Divest, and Sanction Israel",-1,1,0,5,3,-1.5476190476190474,3,5,3,1.023809523809524,-0,3,-3,-3,0,3,0,-3,3,-3,0,1.0301000000238418
8,R_2tbPVD1DV0HLe3w,15,j,2,0,2643.100000023842,Mask mandates,Student worker unionization,-1,-1,3,7,3,1.023809523809524,2,5,4,0.16666666666666682,-3,-2,1,-1,-2,1,2,-1,1,1,1,2.643100000023842
8,R_2tbPVD1DV0HLe3w,16,j,2,0,4187.600000023842,Affirmative action,University Campus should be a Sanctuary,1,-1,3,7,3,1.023809523809524,1,7,3,-0.6904761904761902,3,-1,-4,-2,0,4,0,4,-4,2,1,4.187600000023842
8,R_2tbPVD1DV0HLe3w,17,f,1,1,2564.600000023842,Affirmative action,Remove public Confederate memorials,1,-1,3,7,3,1.023809523809524,2,6,2,0.16666666666666682,3,-2,5,1,1,5,1,5,-5,1,0,2.564600000023842
8,R_2tbPVD1DV0HLe3w,18,f,1,1,1273,Hardening schools/Arming teachers,Tuition increases,-1,-1,3,6,3,1.023809523809524,0,6,3,-1.5476190476190474,-3,-0,-3,3,0,3,0,-3,3,3,0,1.273
8,R_2tbPVD1DV0HLe3w,19,j,2,0,854.1999999284744,Defund Planned Parenthood,Climate change legislation,-1,1,3,6,3,1.023809523809524,3,6,3,1.023809523809524,-3,3,6,0,0,6,0,-6,6,0,1,0.8541999999284744
8,R_2tbPVD1DV0HLe3w,20,j,2,0,1637.0999999046326,Build southern border wall,Climate change legislation,1,1,0,5,3,-1.5476190476190474,3,6,3,1.023809523809524,0,3,3,3,1,3,1,-3,3,-3,1,1.6370999999046325
8,R_2tbPVD1DV0HLe3w,21,f,1,1,2863.7999999523163,Safe injection locations,War on Drugs,1,1,3,6,3,1.023809523809524,1,6,2,-0.6904761904761902,3,1,2,2,0,2,0,2,-2,2,0,2.8637999999523163
8,R_2tbPVD1DV0HLe3w,22,j,2,0,1025.2000000476837,Affirmative action,Mandatory trigger warnings,1,1,3,7,3,1.023809523809524,2,5,2,0.16666666666666682,3,2,-1,-1,-2,1,2,1,-1,1,1,1.0252000000476837
8,R_2tbPVD1DV0HLe3w,23,f,1,1,1556.3000000715256,Abortion rights,Physician-assisted suicide,-1,1,3,5,3,1.023809523809524,1,6,2,-0.6904761904761902,-3,1,-4,2,-1,4,1,-4,4,2,0,1.5563000000715255
8,R_2tbPVD1DV0HLe3w,24,j,2,0,1937.3999999761581,Abortion rights,Physician-assisted suicide,-1,-1,3,5,3,1.023809523809524,1,6,2,-0.6904761904761902,-3,-1,2,-2,1,2,1,-2,2,2,1,1.9373999999761582
8,R_2tbPVD1DV0HLe3w,25,j,2,0,1873.8999999761581,Safe injection locations,Raise the minimum wage,1,1,3,6,3,1.023809523809524,2,4,4,0.16666666666666682,3,2,-1,-1,-2,1,2,1,-1,1,1,1.873899999976158
8,R_2tbPVD1DV0HLe3w,26,f,1,1,1328.8999999761581,Climate change legislation,Affirmative action,1,1,3,6,3,1.023809523809524,3,7,3,1.023809523809524,3,3,0,0,-1,0,1,0,0,0,0,1.3288999999761582
8,R_2tbPVD1DV0HLe3w,27,f,1,1,2462.7000000476837,Climate change legislation,Mandatory training on sexual consent,-1,1,3,6,3,1.023809523809524,1,7,3,-0.6904761904761902,-3,1,-4,2,-1,4,1,-4,4,2,0,2.4627000000476835
8,R_2tbPVD1DV0HLe3w,28,j,2,0,1672.8000000715256,Student worker unionization,Religious exemptions for discrimination laws,1,-1,2,5,4,0.16666666666666682,3,5,3,1.023809523809524,2,-3,-5,1,0,5,0,5,-5,-1,1,1.6728000000715255
8,R_2tbPVD1DV0HLe3w,29,j,2,0,2383.2000000476837,Raise the minimum wage,"Boycott, Divest, and Sanction Israel",-1,-1,2,4,4,0.16666666666666682,3,5,3,1.023809523809524,-2,-3,-1,1,1,1,1,1,-1,-1,1,2.3832000000476836
8,R_2tbPVD1DV0HLe3w,30,f,1,1,1901.1000000238419,Physician-assisted suicide,Ban on research with animals,1,1,1,6,2,-0.6904761904761902,3,5,3,1.023809523809524,1,3,-2,-2,1,2,1,-2,2,-2,0,1.9011000000238418
8,R_2tbPVD1DV0HLe3w,31,f,1,1,2156.8000000715256,Physician-assisted suicide,Abolishing private prisons,1,-1,1,6,2,-0.6904761904761902,3,6,3,1.023809523809524,1,-3,4,-2,0,4,0,4,-4,-2,0,2.1568000000715255
8,R_2tbPVD1DV0HLe3w,32,j,2,0,4317.800000071526,Abortion rights,Mandatory training on sexual consent,1,1,3,5,3,1.023809523809524,1,7,3,-0.6904761904761902,3,1,-2,-2,2,2,2,2,-2,2,1,4.317800000071526
8,R_2tbPVD1DV0HLe3w,33,f,1,1,3523.3000000715256,Detention of migrant children,Expel students with white nationlist views,-1,-1,2,6,2,0.16666666666666682,3,6,3,1.023809523809524,-2,-3,1,-1,0,1,0,1,-1,-1,0,3.5233000000715258
8,R_2tbPVD1DV0HLe3w,34,j,2,0,1445.2000000476837,Legalization of marijuana,Affirmative action,1,1,-1,5,3,-2.4047619047619047,3,7,3,1.023809523809524,-1,3,4,4,2,4,2,-4,4,-4,1,1.4452000000476837
8,R_2tbPVD1DV0HLe3w,35,f,1,1,2106.4000000953674,Mask mandates,Abortion rights,1,-1,3,7,3,1.023809523809524,3,5,3,1.023809523809524,3,-3,6,0,2,6,2,6,-6,0,0,2.1064000000953675
8,R_2tbPVD1DV0HLe3w,36,f,1,1,2224.7000000476837,Student worker unionization,Expel students with white nationlist views,-1,1,2,5,4,0.16666666666666682,3,6,3,1.023809523809524,-2,3,-5,-1,-1,5,1,-5,5,-1,0,2.2247000000476835
8,R_2tbPVD1DV0HLe3w,37,j,2,0,2980.399999976158,Mask mandates,On campus concealed carry,1,-1,3,7,3,1.023809523809524,0,5,3,-1.5476190476190474,3,-0,-3,-3,-2,3,2,3,-3,3,1,2.980399999976158
8,R_2tbPVD1DV0HLe3w,38,j,2,0,1433.2000000476837,Gun-free campus police,Abortion rights,-1,-1,1,7,2,-0.6904761904761902,3,5,3,1.023809523809524,-1,-3,-2,2,-2,2,2,2,-2,-2,1,1.4332000000476837
8,R_2tbPVD1DV0HLe3w,39,f,1,1,1651.8000000715256,Remove public Confederate memorials,Expel students with white nationlist views,1,-1,2,6,2,0.16666666666666682,3,6,3,1.023809523809524,2,-3,5,-1,0,5,0,5,-5,-1,0,1.6518000000715256
8,R_2tbPVD1DV0HLe3w,40,j,2,0,2083.5,Student worker unionization,Affirmative action,-1,1,2,5,4,0.16666666666666682,3,7,3,1.023809523809524,-2,3,5,1,2,5,2,-5,5,-1,1,2.0835
8,R_2tbPVD1DV0HLe3w,41,f,1,1,1614.2999999523163,Detention of migrant children,Safe injection locations,1,1,2,6,2,0.16666666666666682,3,6,3,1.023809523809524,2,3,-1,-1,0,1,0,-1,1,-1,0,1.6142999999523162
8,R_2tbPVD1DV0HLe3w,42,f,1,1,2154.9000000953674,Expel students with white nationlist views,Ban on research with animals,1,-1,3,6,3,1.023809523809524,3,5,3,1.023809523809524,3,-3,6,0,1,6,1,6,-6,0,0,2.1549000000953673
8,R_2tbPVD1DV0HLe3w,43,j,2,0,2398.2999999523163,Remove Christopher Columbus statues,Defund Planned Parenthood,-1,-1,1,5,2,-0.6904761904761902,3,6,3,1.023809523809524,-1,-3,-2,2,1,2,1,2,-2,-2,1,2.3982999999523162
8,R_2tbPVD1DV0HLe3w,44,f,1,1,1902.3999999761581,Affirmative action,Mandatory drug tests for welfare recipients,1,1,3,7,3,1.023809523809524,2,6,2,0.16666666666666682,3,2,1,1,1,1,1,1,-1,1,0,1.902399999976158
8,R_2tbPVD1DV0HLe3w,45,j,2,0,1112.3000000715256,Gun-free campus police,"Boycott, Divest, and Sanction Israel",-1,1,1,7,2,-0.6904761904761902,3,5,3,1.023809523809524,-1,3,4,2,-2,4,2,-4,4,-2,1,1.1123000000715255
8,R_2tbPVD1DV0HLe3w,46,f,1,1,1867.5,"Boycott, Divest, and Sanction Israel","Boycott, Divest, and Sanction Israel",1,-1,3,5,3,1.023809523809524,3,5,3,1.023809523809524,3,-3,6,0,0,6,0,6,-6,0,0,1.8675
8,R_2tbPVD1DV0HLe3w,47,f,1,1,2032,Affirmative action,War on Drugs,1,-1,3,7,3,1.023809523809524,1,6,2,-0.6904761904761902,3,-1,4,2,1,4,1,4,-4,2,0,2.032
8,R_2tbPVD1DV0HLe3w,48,f,1,1,2354.7000000476837,Ban on research with animals,Affirmative action,-1,-1,3,5,3,1.023809523809524,3,7,3,1.023809523809524,-3,-3,0,0,-2,0,2,0,0,0,0,2.354700000047684
8,R_2tbPVD1DV0HLe3w,49,f,1,1,2112.5,Mandatory trigger warnings,Abortion rights,-1,1,2,5,2,0.16666666666666682,3,5,3,1.023809523809524,-2,3,-5,-1,0,5,0,-5,5,-1,0,2.1125
8,R_2tbPVD1DV0HLe3w,50,j,2,0,2046.6999999284744,Tuition increases,Ban on research with animals,1,1,0,6,3,-1.5476190476190474,3,5,3,1.023809523809524,0,3,3,3,-1,3,1,-3,3,-3,1,2.0466999999284745
8,R_2tbPVD1DV0HLe3w,51,f,1,1,1513.2000000476837,Mask mandates,Expel students with white nationlist views,1,-1,3,7,3,1.023809523809524,3,6,3,1.023809523809524,3,-3,6,0,1,6,1,6,-6,0,0,1.5132000000476837
8,R_2tbPVD1DV0HLe3w,52,f,1,1,1372.3000000715256,Mandatory training on sexual consent,"Boycott, Divest, and Sanction Israel",1,-1,1,7,3,-0.6904761904761902,3,5,3,1.023809523809524,1,-3,4,-2,2,4,2,4,-4,-2,0,1.3723000000715255
8,R_2tbPVD1DV0HLe3w,53,j,2,0,2055.100000023842,Climate change legislation,"Boycott, Divest, and Sanction Israel",-1,1,3,6,3,1.023809523809524,3,5,3,1.023809523809524,-3,3,6,0,-1,6,1,-6,6,0,1,2.0551000000238417
8,R_2tbPVD1DV0HLe3w,54,f,1,1,1859.5999999046326,Raise the minimum wage,Safe injection locations,-1,1,2,4,4,0.16666666666666682,3,6,3,1.023809523809524,-2,3,-5,-1,-2,5,2,-5,5,-1,0,1.8595999999046327
8,R_2tbPVD1DV0HLe3w,55,j,2,0,1528.6000000238419,Mask mandates,Cuts to National Parks budget,1,1,3,7,3,1.023809523809524,2,7,2,0.16666666666666682,3,2,-1,-1,0,1,0,1,-1,1,1,1.5286000000238418
8,R_2tbPVD1DV0HLe3w,56,j,2,0,2047.7000000476837,Remove Christopher Columbus statues,Expel students with white nationlist views,1,1,1,5,2,-0.6904761904761902,3,6,3,1.023809523809524,1,3,2,2,1,2,1,-2,2,-2,1,2.047700000047684
8,R_2tbPVD1DV0HLe3w,57,f,1,1,1198,Dorms determined by gender identity,Affirmative action,1,-1,2,5,3,0.16666666666666682,3,7,3,1.023809523809524,2,-3,5,-1,-2,5,2,5,-5,-1,0,1.198
8,R_2tbPVD1DV0HLe3w,58,j,2,0,1904.3999999761581,Mandatory vaccinations,Ban on research with animals,-1,-1,2,7,2,0.16666666666666682,3,5,3,1.023809523809524,-2,-3,-1,1,-2,1,2,1,-1,-1,1,1.904399999976158
8,R_2tbPVD1DV0HLe3w,59,f,1,1,1869.3999999761581,Raise the minimum wage,Abortion rights,1,1,2,4,4,0.16666666666666682,3,5,3,1.023809523809524,2,3,-1,-1,-1,1,1,-1,1,-1,0,1.8693999999761581
8,R_2tbPVD1DV0HLe3w,60,f,1,1,2332.399999976158,Mask mandates,Defund the police,1,-1,3,7,3,1.023809523809524,2,7,2,0.16666666666666682,3,-2,5,1,0,5,0,5,-5,1,0,2.332399999976158
8,R_2tbPVD1DV0HLe3w,61,f,1,1,2123.5,Religious exemptions for discrimination laws,On campus concealed carry,-1,-1,3,5,3,1.023809523809524,0,5,3,-1.5476190476190474,-3,-0,-3,3,0,3,0,-3,3,3,0,2.1235
8,R_2tbPVD1DV0HLe3w,62,j,2,0,1952,Hardening schools/Arming teachers,Mandatory vaccinations,-1,-1,3,6,3,1.023809523809524,2,7,2,0.16666666666666682,-3,-2,1,-1,1,1,1,-1,1,1,1,1.952
8,R_2tbPVD1DV0HLe3w,63,j,2,0,2279.399999976158,Raise the minimum wage,Religious exemptions for discrimination laws,-1,1,2,4,4,0.16666666666666682,3,5,3,1.023809523809524,-2,3,5,1,1,5,1,-5,5,-1,1,2.279399999976158
8,R_2tbPVD1DV0HLe3w,64,j,2,0,1887.6000000238419,Mask mandates,Ban on research with animals,1,1,3,7,3,1.023809523809524,3,5,3,1.023809523809524,3,3,0,0,-2,0,2,0,0,0,1,1.8876000000238418
8,R_2tbPVD1DV0HLe3w,65,j,2,0,1874.7000000476837,Expel students with white nationlist views,Raise the minimum wage,-1,1,3,6,3,1.023809523809524,2,4,4,0.16666666666666682,-3,2,5,-1,-2,5,2,-5,5,1,1,1.8747000000476837
8,R_2tbPVD1DV0HLe3w,66,f,1,1,2186,Abortion rights,Tuition increases,-1,-1,3,5,3,1.023809523809524,0,6,3,-1.5476190476190474,-3,-0,-3,3,-1,3,1,-3,3,3,0,2.186
8,R_2tbPVD1DV0HLe3w,67,f,1,1,1247.5,Defund Planned Parenthood,Mandatory trigger warnings,1,1,3,6,3,1.023809523809524,2,5,2,0.16666666666666682,3,2,1,1,1,1,1,1,-1,1,0,1.2475
8,R_2tbPVD1DV0HLe3w,68,j,2,0,1315.5,Affirmative action,Religious exemptions for discrimination laws,-1,1,3,7,3,1.023809523809524,3,5,3,1.023809523809524,-3,3,6,0,-2,6,2,-6,6,0,1,1.3155
8,R_2tbPVD1DV0HLe3w,69,f,1,1,1248.6000000238419,Defund the police,Climate change legislation,-1,1,2,7,2,0.16666666666666682,3,6,3,1.023809523809524,-2,3,-5,-1,1,5,1,-5,5,-1,0,1.2486000000238417
8,R_2tbPVD1DV0HLe3w,70,j,2,0,1994,Religious exemptions for discrimination laws,Remove Christopher Columbus statues,1,-1,3,5,3,1.023809523809524,1,5,2,-0.6904761904761902,3,-1,-4,-2,0,4,0,4,-4,2,1,1.994
8,R_2tbPVD1DV0HLe3w,71,f,1,1,1728.5,Remove public Confederate memorials,"Boycott, Divest, and Sanction Israel",1,-1,2,6,2,0.16666666666666682,3,5,3,1.023809523809524,2,-3,5,-1,1,5,1,5,-5,-1,0,1.7285
8,R_2tbPVD1DV0HLe3w,72,j,2,0,1013.6000000238419,Gun-free campus police,Climate change legislation,-1,1,1,7,2,-0.6904761904761902,3,6,3,1.023809523809524,-1,3,4,2,-1,4,1,-4,4,-2,1,1.0136000000238419
8,R_2tbPVD1DV0HLe3w,73,f,1,1,1348.7000000476837,Student worker unionization,Ban on research with animals,-1,-1,2,5,4,0.16666666666666682,3,5,3,1.023809523809524,-2,-3,1,-1,0,1,0,1,-1,-1,0,1.3487000000476836
8,R_2tbPVD1DV0HLe3w,74,f,1,1,1100.7999999523163,Remove Christopher Columbus statues,Ban on research with animals,1,1,1,5,2,-0.6904761904761902,3,5,3,1.023809523809524,1,3,-2,-2,0,2,0,-2,2,-2,0,1.1007999999523164
8,R_2tbPVD1DV0HLe3w,75,j,2,0,1890.7999999523163,Mask mandates,Detention of migrant children,-1,-1,3,7,3,1.023809523809524,2,6,2,0.16666666666666682,-3,-2,1,-1,-1,1,1,-1,1,1,1,1.8907999999523162
8,R_2tbPVD1DV0HLe3w,76,f,1,1,1013.7000000476837,Religious exemptions for discrimination laws,Ban on ethnic Halloween costumes,1,1,3,5,3,1.023809523809524,2,6,2,0.16666666666666682,3,2,1,1,-1,1,1,1,-1,1,0,1.0137000000476837
8,R_2tbPVD1DV0HLe3w,77,j,2,0,1859.8999999761581,Abortion rights,Physician-assisted suicide,1,-1,3,5,3,1.023809523809524,1,6,2,-0.6904761904761902,3,-1,-4,-2,1,4,1,4,-4,2,1,1.859899999976158
8,R_2tbPVD1DV0HLe3w,78,j,2,0,1462.2000000476837,"Boycott, Divest, and Sanction Israel",Raise the minimum wage,-1,1,3,5,3,1.023809523809524,2,4,4,0.16666666666666682,-3,2,5,-1,-1,5,1,-5,5,1,1,1.4622000000476838
8,R_2tbPVD1DV0HLe3w,79,j,2,0,2130,Tuition increases,Mask mandates,1,1,0,6,3,-1.5476190476190474,3,7,3,1.023809523809524,0,3,3,3,1,3,1,-3,3,-3,1,2.13
8,R_2tbPVD1DV0HLe3w,80,j,2,0,3684.899999976158,Mask mandates,Mandatory vaccinations,-1,1,3,7,3,1.023809523809524,2,7,2,0.16666666666666682,-3,2,5,-1,0,5,0,-5,5,1,1,3.684899999976158
8,R_2tbPVD1DV0HLe3w,81,f,1,1,1742.8999999761581,Climate change legislation,Mandatory trigger warnings,-1,-1,3,6,3,1.023809523809524,2,5,2,0.16666666666666682,-3,-2,-1,1,1,1,1,-1,1,1,0,1.742899999976158
8,R_2tbPVD1DV0HLe3w,82,f,1,1,2333.5,Religious exemptions for discrimination laws,Abolishing fraternities,-1,-1,3,5,3,1.023809523809524,-1,5,3,-2.4047619047619047,-3,1,-4,4,0,4,0,-4,4,4,0,2.3335
8,R_2tbPVD1DV0HLe3w,83,j,2,0,1287.2000000476837,Religious exemptions for discrimination laws,Defund the police,1,-1,3,5,3,1.023809523809524,2,7,2,0.16666666666666682,3,-2,-5,-1,2,5,2,5,-5,1,1,1.2872000000476838
8,R_2tbPVD1DV0HLe3w,84,f,1,1,1938,Mandatory drug tests for welfare recipients,Expel students with white nationlist views,-1,1,2,6,2,0.16666666666666682,3,6,3,1.023809523809524,-2,3,-5,-1,0,5,0,-5,5,-1,0,1.938
8,R_2tbPVD1DV0HLe3w,85,j,2,0,1474,Increased Gun regulations,Abortion rights,-1,-1,1,5,3,-0.6904761904761902,3,5,3,1.023809523809524,-1,-3,-2,2,0,2,0,2,-2,-2,1,1.474
8,R_2tbPVD1DV0HLe3w,86,j,2,0,2305.1999999284744,On campus concealed carry,Defund Planned Parenthood,-1,-1,0,5,3,-1.5476190476190474,3,6,3,1.023809523809524,-0,-3,-3,3,1,3,1,3,-3,-3,1,2.3051999999284742
8,R_2tbPVD1DV0HLe3w,87,j,2,0,2432.2999999523163,Ban on research with animals,Safe injection locations,-1,-1,3,5,3,1.023809523809524,3,6,3,1.023809523809524,-3,-3,0,0,1,0,1,0,0,0,1,2.4322999999523165
8,R_2tbPVD1DV0HLe3w,88,f,1,1,2477.399999976158,Abolishing private prisons,Dorms determined by gender identity,-1,1,3,6,3,1.023809523809524,2,5,3,0.16666666666666682,-3,2,-5,1,1,5,1,-5,5,1,0,2.477399999976158
8,R_2tbPVD1DV0HLe3w,89,j,2,0,1655.2000000476837,Remove public Confederate memorials,"Boycott, Divest, and Sanction Israel",-1,-1,2,6,2,0.16666666666666682,3,5,3,1.023809523809524,-2,-3,-1,1,-1,1,1,1,-1,-1,1,1.6552000000476836
8,R_2tbPVD1DV0HLe3w,90,j,2,0,1821.8999999761581,Climate change legislation,Remove Christopher Columbus statues,1,-1,3,6,3,1.023809523809524,1,5,2,-0.6904761904761902,3,-1,-4,-2,-1,4,1,4,-4,2,1,1.821899999976158
8,R_2tbPVD1DV0HLe3w,91,j,2,0,2259.7000000476837,Affirmative action,Mask mandates,-1,1,3,7,3,1.023809523809524,3,7,3,1.023809523809524,-3,3,6,0,0,6,0,-6,6,0,1,2.2597000000476837
8,R_2tbPVD1DV0HLe3w,92,f,1,1,2262.9000000953674,Climate change legislation,Mask mandates,-1,-1,3,6,3,1.023809523809524,3,7,3,1.023809523809524,-3,-3,0,0,-1,0,1,0,0,0,0,2.2629000000953674
8,R_2tbPVD1DV0HLe3w,93,j,2,0,2201.8000000715256,Affirmative action,War on Drugs,1,1,3,7,3,1.023809523809524,1,6,2,-0.6904761904761902,3,1,-2,-2,-1,2,1,2,-2,2,1,2.2018000000715254
8,R_2tbPVD1DV0HLe3w,94,j,2,0,1866.7000000476837,War on Drugs,Hardening schools/Arming teachers,-1,-1,1,6,2,-0.6904761904761902,3,6,3,1.023809523809524,-1,-3,-2,2,0,2,0,2,-2,-2,1,1.8667000000476837
8,R_2tbPVD1DV0HLe3w,95,j,2,0,2435,Mandatory training on sexual consent,Affirmative action,1,1,1,7,3,-0.6904761904761902,3,7,3,1.023809523809524,1,3,2,2,0,2,0,-2,2,-2,1,2.435
8,R_2tbPVD1DV0HLe3w,96,j,2,0,3273.600000023842,Mandatory training on sexual consent,Defund Planned Parenthood,-1,-1,1,7,3,-0.6904761904761902,3,6,3,1.023809523809524,-1,-3,-2,2,-1,2,1,2,-2,-2,1,3.273600000023842
8,R_2tbPVD1DV0HLe3w,97,j,2,0,535.9000000953674,Defund Planned Parenthood,Mandatory training on sexual consent,1,1,3,6,3,1.023809523809524,1,7,3,-0.6904761904761902,3,1,-2,-2,1,2,1,2,-2,2,1,0.5359000000953674
8,R_2tbPVD1DV0HLe3w,98,f,1,1,4051.1999999284744,Defund the police,Hardening schools/Arming teachers,1,-1,2,7,2,0.16666666666666682,3,6,3,1.023809523809524,2,-3,5,-1,1,5,1,5,-5,-1,0,4.051199999928475
8,R_2tbPVD1DV0HLe3w,99,j,2,0,1601,Defund Planned Parenthood,Affirmative action,1,-1,3,6,3,1.023809523809524,3,7,3,1.023809523809524,3,-3,-6,0,1,6,1,6,-6,0,1,1.601
8,R_2tbPVD1DV0HLe3w,100,f,1,1,1694.3999999761581,Abolishing private prisons,Physician-assisted suicide,1,-1,3,6,3,1.023809523809524,1,6,2,-0.6904761904761902,3,-1,4,2,0,4,0,4,-4,2,0,1.694399999976158
7,R_2t56Fwl8ddfXWCS,1,j,2,0,1013.3000000119209,Hardening schools/Arming teachers,Dorms determined by gender identity,1,1,0,6,3,-1.5583874449479593,1,5,2,0.25973124082465976,0,1,1,1,-1,1,1,-1,1,-1,1,1.013300000011921
7,R_2t56Fwl8ddfXWCS,2,f,1,1,4797.300000011921,Defund Planned Parenthood,Increased Gun regulations,-1,-1,2,3,2,2.077849926597279,1,7,2,0.25973124082465976,-2,-1,-1,1,-4,1,4,-1,1,1,0,4.797300000011921
7,R_2t56Fwl8ddfXWCS,3,j,2,0,3366.100000023842,Affirmative action,Raise the minimum wage,1,1,1,6,1,0.25973124082465976,2,5,2,2.077849926597279,1,2,1,1,-1,1,1,-1,1,-1,1,3.3661000000238417
7,R_2t56Fwl8ddfXWCS,4,j,2,0,4611.699999988079,Raise the minimum wage,Defund Planned Parenthood,1,1,2,5,2,2.077849926597279,2,3,2,2.077849926597279,2,2,0,0,-2,0,2,0,0,0,1,4.611699999988079
7,R_2t56Fwl8ddfXWCS,5,j,2,0,4947.600000023842,Mask mandates,Increased Gun regulations,-1,-1,-1,4,2,-3.376506130720579,1,7,2,0.25973124082465976,1,-1,-2,2,3,2,3,2,-2,-2,1,4.947600000023842
7,R_2t56Fwl8ddfXWCS,6,f,1,1,3308.5,Defund Planned Parenthood,Mask mandates,-1,-1,2,3,2,2.077849926597279,-1,4,2,-3.376506130720579,-2,1,-3,3,-1,3,1,-3,3,3,0,3.3085
7,R_2t56Fwl8ddfXWCS,7,j,2,0,4730,Physician-assisted suicide,Defund Planned Parenthood,-1,-1,0,5,2,-1.5583874449479593,2,3,2,2.077849926597279,-0,-2,-2,2,-2,2,2,2,-2,-2,1,4.73
7,R_2t56Fwl8ddfXWCS,8,j,2,0,4038.400000035763,Increased Gun regulations,Hardening schools/Arming teachers,-1,-1,1,7,2,0.25973124082465976,0,6,3,-1.5583874449479593,-1,-0,1,-1,-1,1,1,-1,1,1,1,4.038400000035763
7,R_2t56Fwl8ddfXWCS,9,j,2,0,3948.2999999523163,Affirmative action,Defund Planned Parenthood,1,1,1,6,1,0.25973124082465976,2,3,2,2.077849926597279,1,2,1,1,-3,1,3,-1,1,-1,1,3.948299999952316
7,R_2t56Fwl8ddfXWCS,10,f,1,1,4952.800000011921,Detention of migrant children,Defund Planned Parenthood,1,-1,1,5,2,0.25973124082465976,2,3,2,2.077849926597279,1,-2,3,-1,2,3,2,3,-3,-1,0,4.952800000011921
7,R_2t56Fwl8ddfXWCS,11,j,2,0,6821.399999976158,Hardening schools/Arming teachers,Bathrooms restricted based on biological sex,1,-1,0,6,3,-1.5583874449479593,1,6,1,0.25973124082465976,0,-1,-1,1,0,1,0,1,-1,-1,1,6.821399999976158
7,R_2t56Fwl8ddfXWCS,12,j,2,0,4564.800000011921,"Boycott, Divest, and Sanction Israel",Raise the minimum wage,1,1,1,5,2,0.25973124082465976,2,5,2,2.077849926597279,1,2,1,1,0,1,0,-1,1,-1,1,4.564800000011921
7,R_2t56Fwl8ddfXWCS,13,j,2,0,4031.899999976158,Increased Gun regulations,Defund the police,-1,1,1,7,2,0.25973124082465976,1,5,2,0.25973124082465976,-1,1,2,0,-2,2,2,-2,2,0,1,4.031899999976158
7,R_2t56Fwl8ddfXWCS,14,f,1,1,3132,Increased Gun regulations,Lift COVID lockdowns,1,1,1,7,2,0.25973124082465976,1,6,1,0.25973124082465976,1,1,0,0,1,0,1,0,0,0,0,3.132
7,R_2t56Fwl8ddfXWCS,15,j,2,0,2384.800000011921,Raise the minimum wage,Defund Planned Parenthood,-1,-1,2,5,2,2.077849926597279,2,3,2,2.077849926597279,-2,-2,0,0,-2,0,2,0,0,0,1,2.384800000011921
7,R_2t56Fwl8ddfXWCS,16,j,2,0,3989.899999976158,Lift COVID lockdowns,Student worker unionization,1,1,1,6,1,0.25973124082465976,1,5,2,0.25973124082465976,1,1,0,0,-1,0,1,0,0,0,1,3.989899999976158
7,R_2t56Fwl8ddfXWCS,17,j,2,0,8200.399999976158,Mask mandates,Raise the minimum wage,1,-1,-1,4,2,-3.376506130720579,2,5,2,2.077849926597279,-1,-2,-1,3,1,1,1,1,-1,-3,1,8.200399999976158
7,R_2t56Fwl8ddfXWCS,18,j,2,0,2310.800000011921,Defund Planned Parenthood,Raise the minimum wage,-1,1,2,3,2,2.077849926597279,2,5,2,2.077849926597279,-2,2,4,0,2,4,2,-4,4,0,1,2.310800000011921
7,R_2t56Fwl8ddfXWCS,19,f,1,1,4338.599999964237,Defund Planned Parenthood,Mask mandates,1,-1,2,3,2,2.077849926597279,-1,4,2,-3.376506130720579,2,1,1,3,-1,1,1,1,-1,3,0,4.338599999964237
7,R_2t56Fwl8ddfXWCS,20,j,2,0,2507.099999964237,Raise the minimum wage,Raise the minimum wage,-1,1,2,5,2,2.077849926597279,2,5,2,2.077849926597279,-2,2,4,0,0,4,0,-4,4,0,1,2.5070999999642374
7,R_2t56Fwl8ddfXWCS,21,j,2,0,8245.800000011921,Hardening schools/Arming teachers,U.S. drone strikes in Afghanistan,1,-1,0,6,3,-1.5583874449479593,1,5,2,0.25973124082465976,0,-1,-1,1,-1,1,1,1,-1,-1,1,8.24580000001192
7,R_2t56Fwl8ddfXWCS,22,f,1,1,7165.199999988079,Raise the minimum wage,Bathrooms restricted based on biological sex,1,-1,2,5,2,2.077849926597279,1,6,1,0.25973124082465976,2,-1,3,1,-1,3,1,3,-3,1,0,7.165199999988079
7,R_2t56Fwl8ddfXWCS,23,j,2,0,4390.5,Raise the minimum wage,"Boycott, Divest, and Sanction Israel",1,-1,2,5,2,2.077849926597279,1,5,2,0.25973124082465976,2,-1,-3,-1,0,3,0,3,-3,1,1,4.3905
7,R_2t56Fwl8ddfXWCS,24,f,1,1,4985,Defund Planned Parenthood,Increased Gun regulations,-1,1,2,3,2,2.077849926597279,1,7,2,0.25973124082465976,-2,1,-3,1,-4,3,4,-3,3,1,0,4.985
7,R_2t56Fwl8ddfXWCS,25,f,1,1,3643.100000023842,Gun-free campus police,Increased Gun regulations,-1,1,0,5,3,-1.5583874449479593,1,7,2,0.25973124082465976,-0,1,-1,-1,-2,1,2,-1,1,-1,0,3.643100000023842
7,R_2t56Fwl8ddfXWCS,26,f,1,1,4338.600000023842,Affirmative action,Raise the minimum wage,1,-1,1,6,1,0.25973124082465976,2,5,2,2.077849926597279,1,-2,3,-1,1,3,1,3,-3,-1,0,4.338600000023842
7,R_2t56Fwl8ddfXWCS,27,j,2,0,7575.099999964237,Affirmative action,Affirmative action,1,-1,1,6,1,0.25973124082465976,1,6,1,0.25973124082465976,1,-1,-2,0,0,2,0,2,-2,0,1,7.575099999964237
7,R_2t56Fwl8ddfXWCS,28,f,1,1,3504,Increased Gun regulations,Raise the minimum wage,-1,-1,1,7,2,0.25973124082465976,2,5,2,2.077849926597279,-1,-2,1,-1,2,1,2,1,-1,-1,0,3.504
7,R_2t56Fwl8ddfXWCS,29,f,1,1,5572.900000035763,Raise the minimum wage,Increased Gun regulations,-1,1,2,5,2,2.077849926597279,1,7,2,0.25973124082465976,-2,1,-3,1,-2,3,2,-3,3,1,0,5.572900000035763
7,R_2t56Fwl8ddfXWCS,30,j,2,0,5168.400000035763,Increased Gun regulations,Raise the minimum wage,-1,1,1,7,2,0.25973124082465976,2,5,2,2.077849926597279,-1,2,3,1,-2,3,2,-3,3,-1,1,5.168400000035763
7,R_2t56Fwl8ddfXWCS,31,j,2,0,6096.199999988079,Increased Gun regulations,Raise the minimum wage,1,1,1,7,2,0.25973124082465976,2,5,2,2.077849926597279,1,2,1,1,-2,1,2,-1,1,-1,1,6.096199999988079
7,R_2t56Fwl8ddfXWCS,32,j,2,0,13460.699999988079,Increased Gun regulations,Mask mandates,1,1,1,7,2,0.25973124082465976,-1,4,2,-3.376506130720579,1,-1,-2,-2,-3,2,3,2,-2,2,1,13.46069999998808
7,R_2t56Fwl8ddfXWCS,33,f,1,1,3964.800000011921,Mask mandates,Raise the minimum wage,-1,1,-1,4,2,-3.376506130720579,2,5,2,2.077849926597279,1,2,-1,-3,-1,1,1,-1,1,-3,0,3.964800000011921
7,R_2t56Fwl8ddfXWCS,34,j,2,0,3170.699999988079,Mask mandates,Mask mandates,1,-1,-1,4,2,-3.376506130720579,-1,4,2,-3.376506130720579,-1,1,2,0,0,2,0,-2,2,0,1,3.170699999988079
7,R_2t56Fwl8ddfXWCS,35,j,2,0,5309.400000035763,Defund Planned Parenthood,Hardening schools/Arming teachers,1,1,2,3,2,2.077849926597279,0,6,3,-1.5583874449479593,2,0,-2,-2,3,2,3,2,-2,2,1,5.309400000035763
7,R_2t56Fwl8ddfXWCS,36,j,2,0,2706.600000023842,Defund Planned Parenthood,Increased Gun regulations,1,1,2,3,2,2.077849926597279,1,7,2,0.25973124082465976,2,1,-1,-1,4,1,4,1,-1,1,1,2.7066000000238417
7,R_2t56Fwl8ddfXWCS,37,j,2,0,2634.399999976158,Affirmative action,Increased Gun regulations,-1,1,1,6,1,0.25973124082465976,1,7,2,0.25973124082465976,-1,1,2,0,1,2,1,-2,2,0,1,2.634399999976158
7,R_2t56Fwl8ddfXWCS,38,j,2,0,3844.400000035763,Raise the minimum wage,Expel students with white nationlist views,-1,1,2,5,2,2.077849926597279,1,5,2,0.25973124082465976,-2,1,3,-1,0,3,0,-3,3,1,1,3.8444000000357628
7,R_2t56Fwl8ddfXWCS,39,j,2,0,7370.800000011921,Lift COVID lockdowns,Abortion rights,1,-1,1,6,1,0.25973124082465976,1,5,2,0.25973124082465976,1,-1,-2,0,-1,2,1,2,-2,0,1,7.370800000011921
7,R_2t56Fwl8ddfXWCS,40,f,1,1,5540.800000011921,Affirmative action,Raise the minimum wage,1,1,1,6,1,0.25973124082465976,2,5,2,2.077849926597279,1,2,-1,-1,1,1,1,-1,1,-1,0,5.540800000011921
7,R_2t56Fwl8ddfXWCS,41,j,2,0,3060.899999976158,Raise the minimum wage,Hardening schools/Arming teachers,-1,1,2,5,2,2.077849926597279,0,6,3,-1.5583874449479593,-2,0,2,-2,1,2,1,-2,2,2,1,3.0608999999761584
7,R_2t56Fwl8ddfXWCS,42,j,2,0,6549.099999964237,Defund Planned Parenthood,Lift COVID lockdowns,-1,1,2,3,2,2.077849926597279,1,6,1,0.25973124082465976,-2,1,3,-1,3,3,3,-3,3,1,1,6.549099999964238
7,R_2t56Fwl8ddfXWCS,43,j,2,0,3601.699999988079,Remove public Confederate memorials,Lift COVID lockdowns,-1,1,0,5,3,-1.5583874449479593,1,6,1,0.25973124082465976,-0,1,1,1,1,1,1,-1,1,-1,1,3.601699999988079
7,R_2t56Fwl8ddfXWCS,44,f,1,1,5531.5,Mask mandates,Defund Planned Parenthood,1,1,-1,4,2,-3.376506130720579,2,3,2,2.077849926597279,-1,2,-3,-3,1,3,1,-3,3,-3,0,5.5315
7,R_2t56Fwl8ddfXWCS,45,f,1,1,7845.900000035763,Bathrooms restricted based on biological sex,Hardening schools/Arming teachers,1,-1,1,6,1,0.25973124082465976,0,6,3,-1.5583874449479593,1,-0,1,1,0,1,0,1,-1,1,0,7.845900000035763
7,R_2t56Fwl8ddfXWCS,46,j,2,0,4536.800000011921,Ban on ethnic Halloween costumes,Increased Gun regulations,-1,1,1,5,2,0.25973124082465976,1,7,2,0.25973124082465976,-1,1,2,0,2,2,2,-2,2,0,1,4.536800000011921
7,R_2t56Fwl8ddfXWCS,47,j,2,0,2340.199999988079,Defund Planned Parenthood,Mask mandates,-1,1,2,3,2,2.077849926597279,-1,4,2,-3.376506130720579,-2,-1,1,-3,1,1,1,-1,1,3,1,2.340199999988079
7,R_2t56Fwl8ddfXWCS,48,f,1,1,3686.7999999523163,Increased Gun regulations,Raise the minimum wage,-1,1,1,7,2,0.25973124082465976,2,5,2,2.077849926597279,-1,2,-3,-1,2,3,2,-3,3,-1,0,3.686799999952316
7,R_2t56Fwl8ddfXWCS,49,f,1,1,2847.300000011921,Lift COVID lockdowns,Defund Planned Parenthood,-1,-1,1,6,1,0.25973124082465976,2,3,2,2.077849926597279,-1,-2,1,-1,3,1,3,1,-1,-1,0,2.847300000011921
7,R_2t56Fwl8ddfXWCS,50,j,2,0,3601.199999988079,Affirmative action,Mask mandates,-1,1,1,6,1,0.25973124082465976,-1,4,2,-3.376506130720579,-1,-1,0,-2,-2,0,2,0,0,2,1,3.6011999999880793
7,R_2t56Fwl8ddfXWCS,51,f,1,1,2670.899999976158,Bathrooms restricted based on biological sex,Raise the minimum wage,-1,-1,1,6,1,0.25973124082465976,2,5,2,2.077849926597279,-1,-2,1,-1,1,1,1,1,-1,-1,0,2.6708999999761582
7,R_2t56Fwl8ddfXWCS,52,f,1,1,3818.2000000476837,Increased Gun regulations,Mask mandates,1,-1,1,7,2,0.25973124082465976,-1,4,2,-3.376506130720579,1,1,0,2,3,0,3,0,0,2,0,3.8182000000476837
7,R_2t56Fwl8ddfXWCS,53,j,2,0,9603.600000023842,Raise the minimum wage,Ban on ethnic Halloween costumes,-1,-1,2,5,2,2.077849926597279,1,5,2,0.25973124082465976,-2,-1,1,-1,0,1,0,-1,1,1,1,9.603600000023842
7,R_2t56Fwl8ddfXWCS,54,f,1,1,7574,Remove police from schools,Defund Planned Parenthood,-1,-1,1,5,2,0.25973124082465976,2,3,2,2.077849926597279,-1,-2,1,-1,2,1,2,1,-1,-1,0,7.574
7,R_2t56Fwl8ddfXWCS,55,f,1,1,10666.800000011921,Defund Planned Parenthood,Recognize Jerusalem as capital of Israel,1,-1,2,3,2,2.077849926597279,1,5,2,0.25973124082465976,2,-1,3,1,-2,3,2,3,-3,1,0,10.666800000011921
7,R_2t56Fwl8ddfXWCS,56,j,2,0,2432.5,Raise the minimum wage,Mask mandates,-1,-1,2,5,2,2.077849926597279,-1,4,2,-3.376506130720579,-2,1,3,-3,-1,3,1,-3,3,3,1,2.4325
7,R_2t56Fwl8ddfXWCS,57,f,1,1,2095.199999988079,Gun-free campus police,Mask mandates,1,1,0,5,3,-1.5583874449479593,-1,4,2,-3.376506130720579,0,-1,1,1,1,1,1,1,-1,1,0,2.095199999988079
7,R_2t56Fwl8ddfXWCS,58,j,2,0,2777.2999999523163,Raise the minimum wage,Hardening schools/Arming teachers,1,-1,2,5,2,2.077849926597279,0,6,3,-1.5583874449479593,2,-0,-2,-2,1,2,1,2,-2,2,1,2.7772999999523162
7,R_2t56Fwl8ddfXWCS,59,j,2,0,6384.5,Raise the minimum wage,Bathrooms restricted based on biological sex,1,-1,2,5,2,2.077849926597279,1,6,1,0.25973124082465976,2,-1,-3,-1,1,3,1,3,-3,1,1,6.3845
7,R_2t56Fwl8ddfXWCS,60,f,1,1,9920.699999988079,Gun-free campus police,Defund Planned Parenthood,-1,1,0,5,3,-1.5583874449479593,2,3,2,2.077849926597279,-0,2,-2,-2,2,2,2,-2,2,-2,0,9.920699999988079
7,R_2t56Fwl8ddfXWCS,61,j,2,0,6679.800000011921,Remove police from schools,Ban on research with animals,1,-1,1,5,2,0.25973124082465976,0,5,2,-1.5583874449479593,1,-0,-1,-1,0,1,0,1,-1,1,1,6.679800000011921
7,R_2t56Fwl8ddfXWCS,62,j,2,0,3828.600000023842,Legalization of marijuana,Mask mandates,-1,1,1,5,2,0.25973124082465976,-1,4,2,-3.376506130720579,-1,-1,0,-2,-1,0,1,0,0,2,1,3.828600000023842
7,R_2t56Fwl8ddfXWCS,63,f,1,1,2045.800000011921,Raise the minimum wage,Defund Planned Parenthood,1,-1,2,5,2,2.077849926597279,2,3,2,2.077849926597279,2,-2,4,0,2,4,2,4,-4,0,0,2.045800000011921
7,R_2t56Fwl8ddfXWCS,64,f,1,1,2149.600000023842,Defund Planned Parenthood,Raise the minimum wage,1,-1,2,3,2,2.077849926597279,2,5,2,2.077849926597279,2,-2,4,0,-2,4,2,4,-4,0,0,2.1496000000238418
7,R_2t56Fwl8ddfXWCS,65,j,2,0,3071.399999976158,Increased Gun regulations,Ban on research with animals,-1,1,1,7,2,0.25973124082465976,0,5,2,-1.5583874449479593,-1,0,1,-1,-2,1,2,-1,1,1,1,3.0713999999761583
7,R_2t56Fwl8ddfXWCS,66,f,1,1,3494.5,Hardening schools/Arming teachers,Mask mandates,-1,-1,0,6,3,-1.5583874449479593,-1,4,2,-3.376506130720579,-0,1,-1,1,2,1,2,-1,1,1,0,3.4945
7,R_2t56Fwl8ddfXWCS,67,f,1,1,2203.300000011921,Raise the minimum wage,Defund Planned Parenthood,1,1,2,5,2,2.077849926597279,2,3,2,2.077849926597279,2,2,0,0,2,0,2,0,0,0,0,2.2033000000119207
7,R_2t56Fwl8ddfXWCS,68,j,2,0,5186.199999988079,Defund Planned Parenthood,Affirmative action,1,-1,2,3,2,2.077849926597279,1,6,1,0.25973124082465976,2,-1,-3,-1,3,3,3,3,-3,1,1,5.186199999988079
7,R_2t56Fwl8ddfXWCS,69,f,1,1,4033.300000011921,Increased Gun regulations,University Campus should be a Sanctuary,1,1,1,7,2,0.25973124082465976,1,5,2,0.25973124082465976,1,1,0,0,2,0,2,0,0,0,0,4.033300000011921
7,R_2t56Fwl8ddfXWCS,70,j,2,0,2704.2000000476837,"Boycott, Divest, and Sanction Israel",Climate change legislation,-1,1,1,5,2,0.25973124082465976,1,5,2,0.25973124082465976,-1,1,2,0,0,2,0,-2,2,0,1,2.704200000047684
7,R_2t56Fwl8ddfXWCS,71,j,2,0,1936.9000000357628,Hardening schools/Arming teachers,Increased Gun regulations,-1,1,0,6,3,-1.5583874449479593,1,7,2,0.25973124082465976,-0,1,1,1,1,1,1,-1,1,-1,1,1.9369000000357628
7,R_2t56Fwl8ddfXWCS,72,j,2,0,3310.699999988079,Defund the police,Mask mandates,1,1,1,5,2,0.25973124082465976,-1,4,2,-3.376506130720579,1,-1,-2,-2,-1,2,1,2,-2,2,1,3.310699999988079
7,R_2t56Fwl8ddfXWCS,73,f,1,1,2864.100000023842,Hardening schools/Arming teachers,Gun-free campus police,1,-1,0,6,3,-1.5583874449479593,0,5,3,-1.5583874449479593,0,-0,0,0,1,0,1,0,-0,0,0,2.864100000023842
7,R_2t56Fwl8ddfXWCS,74,j,2,0,3429.5,Increased Gun regulations,Affirmative action,-1,-1,1,7,2,0.25973124082465976,1,6,1,0.25973124082465976,-1,-1,0,0,-1,0,1,0,0,0,1,3.4295
7,R_2t56Fwl8ddfXWCS,75,j,2,0,2245.800000011921,Allow alt-right speakers on campus,Increased Gun regulations,-1,-1,1,5,2,0.25973124082465976,1,7,2,0.25973124082465976,-1,-1,0,0,2,0,2,0,0,0,1,2.245800000011921
7,R_2t56Fwl8ddfXWCS,76,j,2,0,2382.800000011921,Defund Planned Parenthood,Defund Planned Parenthood,1,-1,2,3,2,2.077849926597279,2,3,2,2.077849926597279,2,-2,-4,0,0,4,0,4,-4,0,1,2.3828000000119207
7,R_2t56Fwl8ddfXWCS,77,j,2,0,5548.900000035763,Lift COVID lockdowns,Student worker unionization,-1,-1,1,6,1,0.25973124082465976,1,5,2,0.25973124082465976,-1,-1,0,0,-1,0,1,0,0,0,1,5.548900000035763
7,R_2t56Fwl8ddfXWCS,78,j,2,0,3078.2999999523163,University Campus should be a Sanctuary,Mask mandates,-1,-1,1,5,2,0.25973124082465976,-1,4,2,-3.376506130720579,-1,1,2,-2,-1,2,1,-2,2,2,1,3.0782999999523164
7,R_2t56Fwl8ddfXWCS,79,j,2,0,1581.3999999761581,Mask mandates,Lift COVID lockdowns,-1,1,-1,4,2,-3.376506130720579,1,6,1,0.25973124082465976,1,1,0,2,2,0,2,0,0,-2,1,1.581399999976158
7,R_2t56Fwl8ddfXWCS,80,f,1,1,5875.799999952316,Remove public Confederate memorials,Raise the minimum wage,-1,-1,0,5,3,-1.5583874449479593,2,5,2,2.077849926597279,-0,-2,2,-2,0,2,0,2,-2,-2,0,5.875799999952316
7,R_2t56Fwl8ddfXWCS,81,j,2,0,2497.899999976158,Mask mandates,Bathrooms restricted based on biological sex,-1,-1,-1,4,2,-3.376506130720579,1,6,1,0.25973124082465976,1,-1,-2,2,2,2,2,2,-2,-2,1,2.497899999976158
7,R_2t56Fwl8ddfXWCS,82,f,1,1,1621.1000000238419,Mandatory vaccinations,Mask mandates,1,-1,1,5,2,0.25973124082465976,-1,4,2,-3.376506130720579,1,1,0,2,1,0,1,0,0,2,0,1.6211000000238418
7,R_2t56Fwl8ddfXWCS,83,f,1,1,1701.8999999761581,Defund the police,Lift COVID lockdowns,1,-1,1,5,2,0.25973124082465976,1,6,1,0.25973124082465976,1,-1,2,0,-1,2,1,2,-2,0,0,1.7018999999761582
7,R_2t56Fwl8ddfXWCS,84,j,2,0,1780.0999999642372,Mask mandates,Raise the minimum wage,1,1,-1,4,2,-3.376506130720579,2,5,2,2.077849926597279,-1,2,3,3,1,3,1,-3,3,-3,1,1.7800999999642373
7,R_2t56Fwl8ddfXWCS,85,f,1,1,2094.699999988079,Bathrooms restricted based on biological sex,Mask mandates,1,1,1,6,1,0.25973124082465976,-1,4,2,-3.376506130720579,1,-1,2,2,2,2,2,2,-2,2,0,2.094699999988079
7,R_2t56Fwl8ddfXWCS,86,f,1,1,1673.800000011921,Remove public Confederate memorials,Mask mandates,1,-1,0,5,3,-1.5583874449479593,-1,4,2,-3.376506130720579,0,1,-1,1,1,1,1,-1,1,1,0,1.6738000000119209
7,R_2t56Fwl8ddfXWCS,87,f,1,1,2046.1000000238419,Mask mandates,Hardening schools/Arming teachers,1,-1,-1,4,2,-3.376506130720579,0,6,3,-1.5583874449479593,-1,-0,-1,-1,-2,1,2,-1,1,-1,0,2.046100000023842
7,R_2t56Fwl8ddfXWCS,88,f,1,1,3082.5,Raise the minimum wage,Tuition increases,1,1,2,5,2,2.077849926597279,1,5,2,0.25973124082465976,2,1,1,1,0,1,0,1,-1,1,0,3.0825
7,R_2t56Fwl8ddfXWCS,89,f,1,1,1561.800000011921,Raise the minimum wage,Expel students with white nationlist views,1,-1,2,5,2,2.077849926597279,1,5,2,0.25973124082465976,2,-1,3,1,0,3,0,3,-3,1,0,1.561800000011921
7,R_2t56Fwl8ddfXWCS,90,f,1,1,2086.199999988079,Affirmative action,Increased Gun regulations,1,-1,1,6,1,0.25973124082465976,1,7,2,0.25973124082465976,1,-1,2,0,-1,2,1,2,-2,0,0,2.086199999988079
7,R_2t56Fwl8ddfXWCS,91,j,2,0,1858.699999988079,Defund Planned Parenthood,On campus concealed carry,1,1,2,3,2,2.077849926597279,1,5,2,0.25973124082465976,2,1,-1,-1,2,1,2,1,-1,1,1,1.858699999988079
7,R_2t56Fwl8ddfXWCS,93,f,1,1,2865.600000023842,Hardening schools/Arming teachers,Defund Planned Parenthood,1,-1,0,6,3,-1.5583874449479593,2,3,2,2.077849926597279,0,-2,2,-2,3,2,3,2,-2,-2,0,2.865600000023842
7,R_2t56Fwl8ddfXWCS,94,f,1,1,4361.899999976158,Ban on research with animals,Raise the minimum wage,1,1,0,5,2,-1.5583874449479593,2,5,2,2.077849926597279,0,2,-2,-2,0,2,0,-2,2,-2,0,4.361899999976158
7,R_2t56Fwl8ddfXWCS,95,f,1,1,4150.599999964237,Bathrooms restricted based on biological sex,Remove public Confederate memorials,-1,-1,1,6,1,0.25973124082465976,0,5,3,-1.5583874449479593,-1,-0,-1,1,1,1,1,-1,1,1,0,4.150599999964237
7,R_2t56Fwl8ddfXWCS,96,j,2,0,52765.40000003576,Increased Gun regulations,Defund Planned Parenthood,-1,1,1,7,2,0.25973124082465976,2,3,2,2.077849926597279,-1,2,3,1,-4,3,4,-3,3,-1,1,52.76540000003576
7,R_2t56Fwl8ddfXWCS,97,j,2,0,2240.600000023842,Legalization of marijuana,Ban on research with animals,-1,1,1,5,2,0.25973124082465976,0,5,2,-1.5583874449479593,-1,0,1,-1,0,1,0,-1,1,1,1,2.240600000023842
7,R_2t56Fwl8ddfXWCS,98,f,1,1,6472.699999988079,Raise the minimum wage,Raise the minimum wage,-1,1,2,5,2,2.077849926597279,2,5,2,2.077849926597279,-2,2,-4,0,0,4,0,-4,4,0,0,6.472699999988079
7,R_2t56Fwl8ddfXWCS,99,j,2,0,3193.300000011921,Increased Gun regulations,Mask mandates,-1,1,1,7,2,0.25973124082465976,-1,4,2,-3.376506130720579,-1,-1,0,-2,-3,0,3,0,0,2,1,3.193300000011921
7,R_2t56Fwl8ddfXWCS,100,j,2,0,1879.300000011921,Raise the minimum wage,Increased Gun regulations,1,1,2,5,2,2.077849926597279,1,7,2,0.25973124082465976,2,1,-1,-1,2,1,2,1,-1,1,1,1.8793000000119209
2,R_1ir3HZuypop5xQB,1,f,1,1,10683.900000095367,University Campus should be a Sanctuary,Safe injection locations,-1,-1,2,7,2,1.5168173299110996,2,4,1,1.5168173299110996,-2,-2,0,0,3,0,3,0,0,0,0,10.683900000095367
2,R_1ir3HZuypop5xQB,2,j,2,0,1268.6999999284744,Abolishing fraternities,War on Drugs,1,-1,2,6,2,1.5168173299110996,2,5,2,1.5168173299110996,2,-2,-4,0,-1,4,1,4,-4,0,1,1.2686999999284745
2,R_1ir3HZuypop5xQB,3,j,2,0,880.1999999284744,Safe injection locations,Gun-free campus police,1,-1,2,4,1,1.5168173299110996,1,5,2,0.48652631336771124,2,-1,-3,-1,1,3,1,3,-3,1,1,0.8801999999284744
2,R_1ir3HZuypop5xQB,4,f,1,1,600.3999999761581,Hardening schools/Arming teachers,Abolishing fraternities,1,-1,0,4,3,-0.543764703175677,2,6,2,1.5168173299110996,0,-2,2,-2,-2,2,2,2,-2,-2,0,0.6003999999761581
2,R_1ir3HZuypop5xQB,5,f,1,1,1110.5,Safe injection locations,Mandatory drug tests for welfare recipients,-1,1,2,4,1,1.5168173299110996,1,2,1,0.48652631336771124,-2,1,-3,1,2,3,2,-3,3,1,0,1.1105
2,R_1ir3HZuypop5xQB,6,f,1,1,1120.6999999284744,Safe injection locations,Detention of migrant children,-1,1,2,4,1,1.5168173299110996,2,3,3,1.5168173299110996,-2,2,-4,0,1,4,1,-4,4,0,0,1.1206999999284744
2,R_1ir3HZuypop5xQB,7,j,2,0,1162.1000000238419,Safe injection locations,"Boycott, Divest, and Sanction Israel",-1,-1,2,4,1,1.5168173299110996,-1,6,3,-1.5740557197190654,-2,1,3,-3,2,3,2,-3,3,3,1,1.162100000023842
2,R_1ir3HZuypop5xQB,8,f,1,1,907.1000000238419,Remove Christopher Columbus statues,Abolishing fraternities,1,1,0,6,1,-0.543764703175677,2,6,2,1.5168173299110996,0,2,-2,-2,0,2,0,-2,2,-2,0,0.9071000000238418
2,R_1ir3HZuypop5xQB,9,j,2,0,940.3999999761581,Abolishing fraternities,Mandatory drug tests for welfare recipients,-1,1,2,6,2,1.5168173299110996,1,2,1,0.48652631336771124,-2,1,3,-1,-4,3,4,-3,3,1,1,0.9403999999761582
2,R_1ir3HZuypop5xQB,10,f,1,1,585.2999999523163,War on Drugs,Safe injection locations,1,1,2,5,2,1.5168173299110996,2,4,1,1.5168173299110996,2,2,0,0,1,0,1,0,0,0,0,0.5852999999523163
2,R_1ir3HZuypop5xQB,11,f,1,1,2167.5,On campus concealed carry,Recognize Jerusalem as capital of Israel,-1,-1,2,4,2,1.5168173299110996,0,7,3,-0.543764703175677,-2,-0,-2,2,-3,2,3,-2,2,2,0,2.1675
2,R_1ir3HZuypop5xQB,12,f,1,1,1633.6999999284744,Abolishing fraternities,Mandatory drug tests for welfare recipients,-1,-1,2,6,2,1.5168173299110996,1,2,1,0.48652631336771124,-2,-1,-1,1,4,1,4,-1,1,1,0,1.6336999999284745
2,R_1ir3HZuypop5xQB,13,j,2,0,794.2999999523163,"Boycott, Divest, and Sanction Israel",Safe injection locations,1,-1,-1,6,3,-1.5740557197190654,2,4,1,1.5168173299110996,-1,-2,-1,3,-2,1,2,1,-1,-3,1,0.7942999999523163
2,R_1ir3HZuypop5xQB,15,j,2,0,4325.299999952316,War on Drugs,University Campus should be a Sanctuary,1,-1,2,5,2,1.5168173299110996,2,7,2,1.5168173299110996,2,-2,-4,0,2,4,2,4,-4,0,1,4.325299999952316
2,R_1ir3HZuypop5xQB,16,f,1,1,1948.9000000953674,Safe injection locations,Dorms determined by gender identity,-1,-1,2,4,1,1.5168173299110996,1,4,2,0.48652631336771124,-2,-1,-1,1,0,1,0,-1,1,1,0,1.9489000000953673
2,R_1ir3HZuypop5xQB,17,f,1,1,608.6000000238419,Abolishing fraternities,"Boycott, Divest, and Sanction Israel",-1,1,2,6,2,1.5168173299110996,-1,6,3,-1.5740557197190654,-2,-1,-1,3,0,1,0,-1,1,3,0,0.6086000000238418
2,R_1ir3HZuypop5xQB,18,j,2,0,453.5,Abolishing fraternities,University Campus should be a Sanctuary,-1,1,2,6,2,1.5168173299110996,2,7,2,1.5168173299110996,-2,2,4,0,1,4,1,-4,4,0,1,0.4535
2,R_1ir3HZuypop5xQB,19,f,1,1,893.8000000715256,Increased Gun regulations,Abolishing fraternities,-1,-1,1,5,2,0.48652631336771124,2,6,2,1.5168173299110996,-1,-2,1,-1,-1,1,1,1,-1,-1,0,0.8938000000715256
2,R_1ir3HZuypop5xQB,20,f,1,1,3369.2000000476837,Safe injection locations,Mandatory drug tests for welfare recipients,1,1,2,4,1,1.5168173299110996,1,2,1,0.48652631336771124,2,1,1,1,2,1,2,1,-1,1,0,3.369200000047684
2,R_1ir3HZuypop5xQB,21,f,1,1,236.69999992847443,Ban on ethnic Halloween costumes,War on Drugs,-1,1,-1,5,3,-1.5740557197190654,2,5,2,1.5168173299110996,1,2,-1,-3,0,1,0,-1,1,-3,0,0.23669999992847443
2,R_1ir3HZuypop5xQB,22,f,1,1,4596,Expel students with white nationlist views,Safe injection locations,-1,1,2,3,3,1.5168173299110996,2,4,1,1.5168173299110996,-2,2,-4,0,-1,4,1,-4,4,0,0,4.596
2,R_1ir3HZuypop5xQB,23,f,1,1,2111.2999999523163,Abolishing fraternities,"Boycott, Divest, and Sanction Israel",1,1,2,6,2,1.5168173299110996,-1,6,3,-1.5740557197190654,2,-1,3,3,0,3,0,3,-3,3,0,2.1112999999523163
2,R_1ir3HZuypop5xQB,24,f,1,1,515.0999999046326,Abolishing fraternities,Recognize Jerusalem as capital of Israel,1,-1,2,6,2,1.5168173299110996,0,7,3,-0.543764703175677,2,-0,2,2,-1,2,1,2,-2,2,0,0.5150999999046326
2,R_1ir3HZuypop5xQB,25,f,1,1,386,Increased Gun regulations,War on Drugs,-1,1,1,5,2,0.48652631336771124,2,5,2,1.5168173299110996,-1,2,-3,-1,0,3,0,-3,3,-1,0,0.386
2,R_1ir3HZuypop5xQB,26,f,1,1,459.3000000715256,University Campus should be a Sanctuary,Safe injection locations,1,-1,2,7,2,1.5168173299110996,2,4,1,1.5168173299110996,2,-2,4,0,3,4,3,4,-4,0,0,0.45930000007152555
2,R_1ir3HZuypop5xQB,27,j,2,0,1728.6000000238419,Safe injection locations,Safe injection locations,1,-1,2,4,1,1.5168173299110996,2,4,1,1.5168173299110996,2,-2,-4,0,0,4,0,4,-4,0,1,1.728600000023842
2,R_1ir3HZuypop5xQB,28,j,2,0,352.39999997615814,Abolishing fraternities,War on Drugs,1,1,2,6,2,1.5168173299110996,2,5,2,1.5168173299110996,2,2,0,0,-1,0,1,0,0,0,1,0.3523999999761581
2,R_1ir3HZuypop5xQB,29,f,1,1,963.5,Abolishing fraternities,Affirmative action,1,1,2,6,2,1.5168173299110996,1,7,2,0.48652631336771124,2,1,1,1,-1,1,1,1,-1,1,0,0.9635
2,R_1ir3HZuypop5xQB,30,j,2,0,214.29999995231628,Safe injection locations,Gun-free campus police,1,1,2,4,1,1.5168173299110996,1,5,2,0.48652631336771124,2,1,-1,-1,1,1,1,1,-1,1,1,0.21429999995231627
2,R_1ir3HZuypop5xQB,31,f,1,1,314.7000000476837,Dorms determined by gender identity,Abolishing fraternities,1,-1,1,4,2,0.48652631336771124,2,6,2,1.5168173299110996,1,-2,3,-1,-2,3,2,3,-3,-1,0,0.3147000000476837
2,R_1ir3HZuypop5xQB,33,f,1,1,1087.5,Abolishing private prisons,Abolishing fraternities,-1,1,0,5,3,-0.543764703175677,2,6,2,1.5168173299110996,-0,2,-2,-2,-1,2,1,-2,2,-2,0,1.0875
2,R_1ir3HZuypop5xQB,35,j,2,0,401.59999990463257,Affirmative action,War on Drugs,1,1,1,7,2,0.48652631336771124,2,5,2,1.5168173299110996,1,2,1,1,-2,1,2,-1,1,-1,1,0.4015999999046326
2,R_1ir3HZuypop5xQB,36,j,2,0,770.2000000476837,On campus concealed carry,War on Drugs,1,-1,2,4,2,1.5168173299110996,2,5,2,1.5168173299110996,2,-2,-4,0,1,4,1,4,-4,0,1,0.7702000000476837
2,R_1ir3HZuypop5xQB,37,f,1,1,1271.8000000715256,On campus concealed carry,Abolishing fraternities,-1,-1,2,4,2,1.5168173299110996,2,6,2,1.5168173299110996,-2,-2,0,0,-2,0,2,0,0,0,0,1.2718000000715255
2,R_1ir3HZuypop5xQB,38,f,1,1,1704.7999999523163,Hardening schools/Arming teachers,Abolishing fraternities,1,1,0,4,3,-0.543764703175677,2,6,2,1.5168173299110996,0,2,-2,-2,-2,2,2,-2,2,-2,0,1.7047999999523162
2,R_1ir3HZuypop5xQB,39,f,1,1,859.6999999284744,Abolishing fraternities,Remove Christopher Columbus statues,-1,1,2,6,2,1.5168173299110996,0,6,1,-0.543764703175677,-2,0,-2,2,0,2,0,-2,2,2,0,0.8596999999284745
2,R_1ir3HZuypop5xQB,40,f,1,1,503.7000000476837,Abolishing fraternities,Climate change legislation,1,1,2,6,2,1.5168173299110996,1,4,2,0.48652631336771124,2,1,1,1,2,1,2,1,-1,1,0,0.5037000000476837
2,R_1ir3HZuypop5xQB,41,j,2,0,309.2999999523163,Cuts to National Parks budget,War on Drugs,1,1,1,4,2,0.48652631336771124,2,5,2,1.5168173299110996,1,2,1,1,1,1,1,-1,1,-1,1,0.3092999999523163
2,R_1ir3HZuypop5xQB,42,f,1,1,365.09999990463257,Mandatory drug tests for welfare recipients,Safe injection locations,-1,-1,1,2,1,0.48652631336771124,2,4,1,1.5168173299110996,-1,-2,1,-1,-2,1,2,1,-1,-1,0,0.36509999990463254
2,R_1ir3HZuypop5xQB,43,f,1,1,226.5,On campus concealed carry,University Campus should be a Sanctuary,1,-1,2,4,2,1.5168173299110996,2,7,2,1.5168173299110996,2,-2,4,0,-3,4,3,4,-4,0,0,0.2265
2,R_1ir3HZuypop5xQB,44,f,1,1,158.70000004768372,"Boycott, Divest, and Sanction Israel",Abolishing fraternities,-1,1,-1,6,3,-1.5740557197190654,2,6,2,1.5168173299110996,1,2,-1,-3,0,1,0,-1,1,-3,0,0.15870000004768373
2,R_1ir3HZuypop5xQB,45,f,1,1,1094.2999999523163,University Campus should be a Sanctuary,Abolishing fraternities,-1,1,2,7,2,1.5168173299110996,2,6,2,1.5168173299110996,-2,2,-4,0,1,4,1,-4,4,0,0,1.0942999999523162
2,R_1ir3HZuypop5xQB,46,f,1,1,1089.1000000238419,Abolishing fraternities,"Boycott, Divest, and Sanction Israel",-1,-1,2,6,2,1.5168173299110996,-1,6,3,-1.5740557197190654,-2,1,-3,3,0,3,0,-3,3,3,0,1.0891000000238418
2,R_1ir3HZuypop5xQB,47,f,1,1,207.19999992847443,Lift COVID lockdowns,Abolishing fraternities,1,-1,0,2,3,-0.543764703175677,2,6,2,1.5168173299110996,0,-2,2,-2,-4,2,4,2,-2,-2,0,0.20719999992847443
2,R_1ir3HZuypop5xQB,48,f,1,1,970.6999999284744,Abolishing private prisons,Safe injection locations,1,-1,0,5,3,-0.543764703175677,2,4,1,1.5168173299110996,0,-2,2,-2,1,2,1,2,-2,-2,0,0.9706999999284744
2,R_1ir3HZuypop5xQB,49,j,2,0,1095.5,Stop police brutality,Safe injection locations,1,-1,-1,7,3,-1.5740557197190654,2,4,1,1.5168173299110996,-1,-2,-1,3,-3,1,3,1,-1,-3,1,1.0955
2,R_1ir3HZuypop5xQB,50,j,2,0,2314.7999999523163,War on Drugs,Expel students with white nationlist views,1,1,2,5,2,1.5168173299110996,2,3,3,1.5168173299110996,2,2,0,0,-2,0,2,0,0,0,1,2.3147999999523163
2,R_1ir3HZuypop5xQB,52,f,1,1,781.7000000476837,Safe injection locations,Bathrooms restricted based on biological sex,-1,1,2,4,1,1.5168173299110996,0,2,3,-0.543764703175677,-2,0,-2,2,2,2,2,-2,2,2,0,0.7817000000476837
2,R_1ir3HZuypop5xQB,53,f,1,1,235,Ban on ethnic Halloween costumes,Abolishing fraternities,-1,-1,-1,5,3,-1.5740557197190654,2,6,2,1.5168173299110996,1,-2,3,-3,-1,3,1,3,-3,-3,0,0.235
2,R_1ir3HZuypop5xQB,54,j,2,0,1037.1000000238419,Remove Christopher Columbus statues,On campus concealed carry,-1,1,0,6,1,-0.543764703175677,2,4,2,1.5168173299110996,-0,2,2,2,-2,2,2,-2,2,-2,1,1.037100000023842
2,R_1ir3HZuypop5xQB,55,j,2,0,443.2999999523163,Abolishing fraternities,War on Drugs,-1,-1,2,6,2,1.5168173299110996,2,5,2,1.5168173299110996,-2,-2,0,0,-1,0,1,0,0,0,1,0.4432999999523163
2,R_1ir3HZuypop5xQB,56,j,2,0,462.39999997615814,Black Lives Matter,On campus concealed carry,-1,1,1,4,2,0.48652631336771124,2,4,2,1.5168173299110996,-1,2,3,1,0,3,0,-3,3,-1,1,0.46239999997615816
2,R_1ir3HZuypop5xQB,57,j,2,0,1151.7000000476837,Abolishing fraternities,University Campus should be a Sanctuary,1,1,2,6,2,1.5168173299110996,2,7,2,1.5168173299110996,2,2,0,0,1,0,1,0,0,0,1,1.1517000000476838
2,R_1ir3HZuypop5xQB,58,f,1,1,944.7999999523163,Abolishing fraternities,University Campus should be a Sanctuary,-1,-1,2,6,2,1.5168173299110996,2,7,2,1.5168173299110996,-2,-2,0,0,-1,0,1,0,0,0,0,0.9447999999523163
2,R_1ir3HZuypop5xQB,59,f,1,1,291,War on Drugs,Stop police brutality,1,1,2,5,2,1.5168173299110996,-1,7,3,-1.5740557197190654,2,-1,3,3,-2,3,2,3,-3,3,0,0.291
2,R_1ir3HZuypop5xQB,60,f,1,1,229,Safe injection locations,Expel students with white nationlist views,-1,-1,2,4,1,1.5168173299110996,2,3,3,1.5168173299110996,-2,-2,0,0,1,0,1,0,0,0,0,0.229
2,R_1ir3HZuypop5xQB,61,f,1,1,2163.600000023842,Abolishing fraternities,Abolishing fraternities,1,-1,2,6,2,1.5168173299110996,2,6,2,1.5168173299110996,2,-2,4,0,0,4,0,4,-4,0,0,2.163600000023842
2,R_1ir3HZuypop5xQB,62,f,1,1,519.2000000476837,Safe injection locations,Mask mandates,1,-1,2,4,1,1.5168173299110996,0,4,3,-0.543764703175677,2,-0,2,2,0,2,0,2,-2,2,0,0.5192000000476837
2,R_1ir3HZuypop5xQB,63,f,1,1,671.4000000953674,War on Drugs,On campus concealed carry,-1,-1,2,5,2,1.5168173299110996,2,4,2,1.5168173299110996,-2,-2,0,0,1,0,1,0,0,0,0,0.6714000000953674
2,R_1ir3HZuypop5xQB,64,j,2,0,448.10000002384186,Abolishing fraternities,Expel students with white nationlist views,-1,-1,2,6,2,1.5168173299110996,2,3,3,1.5168173299110996,-2,-2,0,0,-3,0,3,0,0,0,1,0.44810000002384187
2,R_1ir3HZuypop5xQB,65,j,2,0,1105.5,Defund the police,On campus concealed carry,-1,1,1,7,2,0.48652631336771124,2,4,2,1.5168173299110996,-1,2,3,1,-3,3,3,-3,3,-1,1,1.1055
2,R_1ir3HZuypop5xQB,66,j,2,0,694,Abolishing fraternities,Recognize Jerusalem as capital of Israel,-1,1,2,6,2,1.5168173299110996,0,7,3,-0.543764703175677,-2,0,2,-2,1,2,1,-2,2,2,1,0.694
2,R_1ir3HZuypop5xQB,67,f,1,1,344.89999997615814,Cuts to National Parks budget,Safe injection locations,1,1,1,4,2,0.48652631336771124,2,4,1,1.5168173299110996,1,2,-1,-1,0,1,0,-1,1,-1,0,0.34489999997615817
2,R_1ir3HZuypop5xQB,68,j,2,0,855.1000000238419,Safe injection locations,Mandatory training on sexual consent,-1,1,2,4,1,1.5168173299110996,0,4,2,-0.543764703175677,-2,0,2,-2,0,2,0,-2,2,2,1,0.8551000000238419
2,R_1ir3HZuypop5xQB,69,f,1,1,1558.7999999523163,Abolishing fraternities,Detention of migrant children,1,-1,2,6,2,1.5168173299110996,2,3,3,1.5168173299110996,2,-2,4,0,3,4,3,4,-4,0,0,1.5587999999523163
2,R_1ir3HZuypop5xQB,70,f,1,1,258.60000002384186,Safe injection locations,Abolishing private prisons,1,1,2,4,1,1.5168173299110996,0,5,3,-0.543764703175677,2,0,2,2,-1,2,1,2,-2,2,0,0.25860000002384187
2,R_1ir3HZuypop5xQB,71,f,1,1,860,Abolishing fraternities,Black Lives Matter,-1,-1,2,6,2,1.5168173299110996,1,4,2,0.48652631336771124,-2,-1,-1,1,2,1,2,-1,1,1,0,0.86
2,R_1ir3HZuypop5xQB,72,j,2,0,534.0999999046326,War on Drugs,Abolishing fraternities,1,-1,2,5,2,1.5168173299110996,2,6,2,1.5168173299110996,2,-2,-4,0,1,4,1,4,-4,0,1,0.5340999999046325
2,R_1ir3HZuypop5xQB,73,j,2,0,875.3999999761581,Bathrooms restricted based on biological sex,On campus concealed carry,-1,1,0,2,3,-0.543764703175677,2,4,2,1.5168173299110996,-0,2,2,2,2,2,2,-2,2,-2,1,0.8753999999761581
2,R_1ir3HZuypop5xQB,74,f,1,1,184.80000007152557,"Boycott, Divest, and Sanction Israel",On campus concealed carry,1,1,-1,6,3,-1.5740557197190654,2,4,2,1.5168173299110996,-1,2,-3,-3,2,3,2,-3,3,-3,0,0.18480000007152558
2,R_1ir3HZuypop5xQB,76,j,2,0,263.89999997615814,Ban on ethnic Halloween costumes,Abolishing fraternities,-1,1,-1,5,3,-1.5740557197190654,2,6,2,1.5168173299110996,1,2,1,3,1,1,1,-1,1,-3,1,0.26389999997615815
2,R_1ir3HZuypop5xQB,77,f,1,1,1044.8999999761581,War on Drugs,War on Drugs,-1,1,2,5,2,1.5168173299110996,2,5,2,1.5168173299110996,-2,2,-4,0,0,4,0,-4,4,0,0,1.0448999999761581
2,R_1ir3HZuypop5xQB,78,f,1,1,352.5,Abolishing fraternities,On campus concealed carry,1,1,2,6,2,1.5168173299110996,2,4,2,1.5168173299110996,2,2,0,0,2,0,2,0,0,0,0,0.3525
2,R_1ir3HZuypop5xQB,81,j,2,0,327.7999999523163,Ban on ethnic Halloween costumes,On campus concealed carry,1,-1,-1,5,3,-1.5740557197190654,2,4,2,1.5168173299110996,-1,-2,-1,3,-1,1,1,1,-1,-3,1,0.3277999999523163
2,R_1ir3HZuypop5xQB,82,j,2,0,423.89999997615814,On campus concealed carry,Gun-free campus police,-1,1,2,4,2,1.5168173299110996,1,5,2,0.48652631336771124,-2,1,3,-1,1,3,1,-3,3,1,1,0.4238999999761581
2,R_1ir3HZuypop5xQB,83,f,1,1,151,Detention of migrant children,Abolishing fraternities,1,-1,2,3,3,1.5168173299110996,2,6,2,1.5168173299110996,2,-2,4,0,-3,4,3,4,-4,0,0,0.151
2,R_1ir3HZuypop5xQB,84,j,2,0,216,On campus concealed carry,Affirmative action,1,1,2,4,2,1.5168173299110996,1,7,2,0.48652631336771124,2,1,-1,-1,3,1,3,1,-1,1,1,0.216
2,R_1ir3HZuypop5xQB,85,j,2,0,235.39999997615814,Abolishing fraternities,Stop police brutality,1,1,2,6,2,1.5168173299110996,-1,7,3,-1.5740557197190654,2,-1,-3,-3,1,3,1,3,-3,3,1,0.23539999997615815
2,R_1ir3HZuypop5xQB,88,j,2,0,624.1999999284744,Mandatory drug tests for welfare recipients,Abolishing fraternities,1,1,1,2,1,0.48652631336771124,2,6,2,1.5168173299110996,1,2,1,1,4,1,4,-1,1,-1,1,0.6241999999284744
2,R_1ir3HZuypop5xQB,89,j,2,0,607.6000000238419,Recognize Jerusalem as capital of Israel,Safe injection locations,-1,1,0,7,3,-0.543764703175677,2,4,1,1.5168173299110996,-0,2,2,2,-3,2,3,-2,2,-2,1,0.6076000000238418
2,R_1ir3HZuypop5xQB,90,j,2,0,742.2000000476837,Dorms determined by gender identity,On campus concealed carry,1,-1,1,4,2,0.48652631336771124,2,4,2,1.5168173299110996,1,-2,-3,1,0,3,0,3,-3,-1,1,0.7422000000476837
2,R_1ir3HZuypop5xQB,91,j,2,0,533.5,On campus concealed carry,Abolishing fraternities,1,-1,2,4,2,1.5168173299110996,2,6,2,1.5168173299110996,2,-2,-4,0,2,4,2,4,-4,0,1,0.5335
2,R_1ir3HZuypop5xQB,93,j,2,0,310.7000000476837,On campus concealed carry,"Boycott, Divest, and Sanction Israel",1,-1,2,4,2,1.5168173299110996,-1,6,3,-1.5740557197190654,2,1,-1,-3,2,1,2,1,-1,3,1,0.3107000000476837
2,R_1ir3HZuypop5xQB,94,j,2,0,279.10000002384186,Mandatory drug tests for welfare recipients,On campus concealed carry,-1,1,1,2,1,0.48652631336771124,2,4,2,1.5168173299110996,-1,2,3,1,2,3,2,-3,3,-1,1,0.27910000002384183
2,R_1ir3HZuypop5xQB,96,j,2,0,825.3999999761581,Safe injection locations,Affirmative action,-1,1,2,4,1,1.5168173299110996,1,7,2,0.48652631336771124,-2,1,3,-1,3,3,3,-3,3,1,1,0.8253999999761581
2,R_1ir3HZuypop5xQB,97,f,1,1,165.40000009536743,Abolishing fraternities,Expel students with white nationlist views,1,1,2,6,2,1.5168173299110996,2,3,3,1.5168173299110996,2,2,0,0,3,0,3,0,0,0,0,0.16540000009536743
2,R_1ir3HZuypop5xQB,98,f,1,1,256.7000000476837,War on Drugs,Safe injection locations,1,-1,2,5,2,1.5168173299110996,2,4,1,1.5168173299110996,2,-2,4,0,1,4,1,4,-4,0,0,0.25670000004768373
2,R_1ir3HZuypop5xQB,99,f,1,1,361.2000000476837,University Campus should be a Sanctuary,War on Drugs,1,1,2,7,2,1.5168173299110996,2,5,2,1.5168173299110996,2,2,0,0,2,0,2,0,0,0,0,0.3612000000476837
6,R_2Si8iSDiTMldrAB,1,j,2,0,11777.300000000745,Climate change legislation,On campus concealed carry,-1,1,3,8,3,1.1278690186247062,1,1,3,0.31874559222002574,-3,1,4,-2,-7,4,7,-4,4,2,1,11.777300000000745
6,R_2Si8iSDiTMldrAB,2,j,2,0,4628.199999999255,Bathrooms restricted based on biological sex,Build southern border wall,1,-1,-3,4,4,-1.2995012605893355,-3,8,4,-1.2995012605893355,-3,3,6,0,4,6,4,-6,6,0,1,4.628199999999255
6,R_2Si8iSDiTMldrAB,3,f,1,1,7049.0999999996275,Cuts to National Parks budget,Student worker unionization,-1,-1,-2,5,3,-0.8949395473869951,3,5,4,1.1278690186247062,2,-3,5,-5,0,5,0,5,-5,-5,0,7.049099999999627
6,R_2Si8iSDiTMldrAB,4,f,1,1,3372.9000000003725,Student worker unionization,Mask mandates,-1,-1,3,5,4,1.1278690186247062,3,7,4,1.1278690186247062,-3,-3,0,0,-2,0,2,0,0,0,0,3.3729000000003726
6,R_2Si8iSDiTMldrAB,5,f,1,1,3633.9000000003725,Climate change legislation,Defund Planned Parenthood,1,1,3,8,3,1.1278690186247062,-3,7,2,-1.2995012605893355,3,-3,6,6,1,6,1,6,-6,6,0,3.6339000000003727
6,R_2Si8iSDiTMldrAB,6,f,1,1,4636.5999999996275,Affirmative action,Abolishing private prisons,1,-1,2,4,3,0.7233073054223661,3,8,4,1.1278690186247062,2,-3,5,-1,-4,5,4,5,-5,-1,0,4.6365999999996275
6,R_2Si8iSDiTMldrAB,7,f,1,1,3763,Black Lives Matter,Allow alt-right speakers on campus,1,1,3,8,4,1.1278690186247062,-3,6,4,-1.2995012605893355,3,-3,6,6,2,6,2,6,-6,6,0,3.763
6,R_2Si8iSDiTMldrAB,8,f,1,1,6612.9000000003725,Expel students with white nationlist views,War on Drugs,-1,1,3,8,4,1.1278690186247062,-3,7,4,-1.2995012605893355,-3,-3,0,6,1,0,1,0,0,6,0,6.612900000000373
6,R_2Si8iSDiTMldrAB,9,f,1,1,4194.0999999996275,Remove police from schools,Climate change legislation,-1,-1,1,2,4,0.31874559222002574,3,8,3,1.1278690186247062,-1,-3,2,-2,-6,2,6,2,-2,-2,0,4.194099999999628
6,R_2Si8iSDiTMldrAB,10,j,2,0,4783.5,On campus concealed carry,Student worker unionization,-1,1,1,1,3,0.31874559222002574,3,5,4,1.1278690186247062,-1,3,4,2,4,4,4,-4,4,-2,1,4.7835
6,R_2Si8iSDiTMldrAB,11,f,1,1,5525.5,Student worker unionization,Increased Gun regulations,-1,-1,3,5,4,1.1278690186247062,2,6,3,0.7233073054223661,-3,-2,-1,1,-1,1,1,-1,1,1,0,5.5255
6,R_2Si8iSDiTMldrAB,12,f,1,1,8602.10000000149,On campus concealed carry,Climate change legislation,-1,-1,1,1,3,0.31874559222002574,3,8,3,1.1278690186247062,-1,-3,2,-2,-7,2,7,2,-2,-2,0,8.60210000000149
6,R_2Si8iSDiTMldrAB,13,f,1,1,26663.60000000149,Student worker unionization,Ban on research with animals,1,-1,3,5,4,1.1278690186247062,-1,0,3,-0.4903778341846548,3,1,2,4,5,2,5,2,-2,4,0,26.66360000000149
6,R_2Si8iSDiTMldrAB,14,j,2,0,2640.4000000003725,War on Drugs,Student worker unionization,1,1,-3,7,4,-1.2995012605893355,3,5,4,1.1278690186247062,-3,3,6,6,-2,6,2,-6,6,-6,1,2.6404000000003727
6,R_2Si8iSDiTMldrAB,15,j,2,0,8270.800000000745,Religious exemptions for discrimination laws,Student worker unionization,1,1,-1,0,1,-0.4903778341846548,3,5,4,1.1278690186247062,-1,3,4,4,5,4,5,-4,4,-4,1,8.270800000000746
6,R_2Si8iSDiTMldrAB,16,j,2,0,2937.0999999996275,Student worker unionization,On campus concealed carry,-1,1,3,5,4,1.1278690186247062,1,1,3,0.31874559222002574,-3,1,4,-2,-4,4,4,-4,4,2,1,2.9370999999996275
6,R_2Si8iSDiTMldrAB,17,j,2,0,2885.800000000745,Bathrooms restricted based on biological sex,Student worker unionization,1,-1,-3,4,4,-1.2995012605893355,3,5,4,1.1278690186247062,-3,-3,0,6,1,0,1,0,0,-6,1,2.885800000000745
6,R_2Si8iSDiTMldrAB,18,f,1,1,16392.5,Abolishing private prisons,Mask mandates,1,1,3,8,4,1.1278690186247062,3,7,4,1.1278690186247062,3,3,0,0,1,0,1,0,0,0,0,16.3925
6,R_2Si8iSDiTMldrAB,19,j,2,0,20376,Student worker unionization,Remove police from schools,-1,1,3,5,4,1.1278690186247062,1,2,4,0.31874559222002574,-3,1,4,-2,-3,4,3,-4,4,2,1,20.376
6,R_2Si8iSDiTMldrAB,20,j,2,0,20417.199999999255,Mandatory vaccinations,Student worker unionization,-1,1,1,6,3,0.31874559222002574,3,5,4,1.1278690186247062,-1,3,4,2,-1,4,1,-4,4,-2,1,20.417199999999255
6,R_2Si8iSDiTMldrAB,21,f,1,1,3970.7999999988824,Increased Gun regulations,Student worker unionization,1,1,2,6,3,0.7233073054223661,3,5,4,1.1278690186247062,2,3,-1,-1,1,1,1,-1,1,-1,0,3.9707999999988823
6,R_2Si8iSDiTMldrAB,22,f,1,1,6911.9000000003725,Student worker unionization,Hardening schools/Arming teachers,-1,1,3,5,4,1.1278690186247062,-3,6,4,-1.2995012605893355,-3,-3,0,6,-1,0,1,0,0,6,0,6.911900000000372
6,R_2Si8iSDiTMldrAB,23,f,1,1,3215.2999999988824,Student worker unionization,Dorms determined by gender identity,-1,1,3,5,4,1.1278690186247062,-2,4,1,-0.8949395473869951,-3,-2,-1,5,1,1,1,-1,1,5,0,3.2152999999988823
6,R_2Si8iSDiTMldrAB,24,j,2,0,1771.3999999985099,Abolishing private prisons,Student worker unionization,-1,1,3,8,4,1.1278690186247062,3,5,4,1.1278690186247062,-3,3,6,0,-3,6,3,-6,6,0,1,1.77139999999851
6,R_2Si8iSDiTMldrAB,25,j,2,0,2961.4000000003725,Student worker unionization,Allow alt-right speakers on campus,-1,-1,3,5,4,1.1278690186247062,-3,6,4,-1.2995012605893355,-3,3,6,-6,1,6,1,-6,6,6,1,2.9614000000003724
6,R_2Si8iSDiTMldrAB,26,j,2,0,5294.700000001118,Build southern border wall,Abolishing fraternities,1,1,-3,8,4,-1.2995012605893355,1,4,3,0.31874559222002574,-3,1,4,4,-4,4,4,-4,4,-4,1,5.294700000001118
6,R_2Si8iSDiTMldrAB,27,f,1,1,10465.099999999627,Ban on research with animals,Stop police brutality,1,-1,-1,0,3,-0.4903778341846548,3,8,4,1.1278690186247062,-1,-3,2,-4,-8,2,8,2,-2,-4,0,10.465099999999627
6,R_2Si8iSDiTMldrAB,28,j,2,0,10949.199999999255,Raise the minimum wage,Increased Gun regulations,-1,1,3,8,4,1.1278690186247062,2,6,3,0.7233073054223661,-3,2,5,-1,-2,5,2,-5,5,1,1,10.949199999999255
6,R_2Si8iSDiTMldrAB,29,j,2,0,20004,Student worker unionization,Mandatory trigger warnings,1,1,3,5,4,1.1278690186247062,2,5,3,0.7233073054223661,3,2,-1,-1,0,1,0,1,-1,1,1,20.004
6,R_2Si8iSDiTMldrAB,30,f,1,1,5703.5999999996275,Ban on research with animals,Student worker unionization,-1,-1,-1,0,3,-0.4903778341846548,3,5,4,1.1278690186247062,1,-3,4,-4,-5,4,5,4,-4,-4,0,5.703599999999628
6,R_2Si8iSDiTMldrAB,31,f,1,1,2383.39999999851,Bathrooms restricted based on biological sex,Black Lives Matter,1,-1,-3,4,4,-1.2995012605893355,3,8,4,1.1278690186247062,-3,-3,0,-6,-4,0,4,0,0,-6,0,2.38339999999851
6,R_2Si8iSDiTMldrAB,32,f,1,1,6345.700000001118,Mask mandates,Student worker unionization,1,1,3,7,4,1.1278690186247062,3,5,4,1.1278690186247062,3,3,0,0,2,0,2,0,0,0,0,6.345700000001117
6,R_2Si8iSDiTMldrAB,33,j,2,0,3702.0999999996275,Religious exemptions for discrimination laws,Student worker unionization,1,-1,-1,0,1,-0.4903778341846548,3,5,4,1.1278690186247062,-1,-3,-2,4,5,2,5,2,-2,-4,1,3.7020999999996276
6,R_2Si8iSDiTMldrAB,34,j,2,0,13820.199999999255,Student worker unionization,Remove police from schools,1,1,3,5,4,1.1278690186247062,1,2,4,0.31874559222002574,3,1,-2,-2,-3,2,3,2,-2,2,1,13.820199999999256
6,R_2Si8iSDiTMldrAB,35,j,2,0,14601.699999999255,Expel students with white nationlist views,Cuts to National Parks budget,-1,1,3,8,4,1.1278690186247062,-2,5,3,-0.8949395473869951,-3,-2,1,-5,-3,1,3,-1,1,5,1,14.601699999999255
6,R_2Si8iSDiTMldrAB,36,f,1,1,2859.89999999851,On campus concealed carry,Student worker unionization,1,1,1,1,3,0.31874559222002574,3,5,4,1.1278690186247062,1,3,-2,-2,-4,2,4,-2,2,-2,0,2.8598999999985097
6,R_2Si8iSDiTMldrAB,37,j,2,0,3116.0999999996275,Increased Gun regulations,Climate change legislation,-1,1,2,6,3,0.7233073054223661,3,8,3,1.1278690186247062,-2,3,5,1,2,5,2,-5,5,-1,1,3.1160999999996273
6,R_2Si8iSDiTMldrAB,38,f,1,1,3608.5,Student worker unionization,Affirmative action,1,-1,3,5,4,1.1278690186247062,2,4,3,0.7233073054223661,3,-2,5,1,1,5,1,5,-5,1,0,3.6085
6,R_2Si8iSDiTMldrAB,39,j,2,0,17779.5,Ban on research with animals,Raise the minimum wage,1,1,-1,0,3,-0.4903778341846548,3,8,4,1.1278690186247062,-1,3,4,4,8,4,8,-4,4,-4,1,17.7795
6,R_2Si8iSDiTMldrAB,40,j,2,0,28775.400000000373,Climate change legislation,Bathrooms restricted based on biological sex,-1,-1,3,8,3,1.1278690186247062,-3,4,4,-1.2995012605893355,-3,3,6,-6,-4,6,4,-6,6,6,1,28.775400000000374
6,R_2Si8iSDiTMldrAB,41,f,1,1,5340.9000000003725,Dorms determined by gender identity,Student worker unionization,-1,1,-2,4,1,-0.8949395473869951,3,5,4,1.1278690186247062,2,3,-1,-5,-1,1,1,-1,1,-5,0,5.340900000000373
6,R_2Si8iSDiTMldrAB,42,f,1,1,5650.89999999851,Student worker unionization,Student worker unionization,1,-1,3,5,4,1.1278690186247062,3,5,4,1.1278690186247062,3,-3,6,0,0,6,0,6,-6,0,0,5.65089999999851
6,R_2Si8iSDiTMldrAB,43,j,2,0,2071.699999999255,Mandatory vaccinations,Student worker unionization,-1,-1,1,6,3,0.31874559222002574,3,5,4,1.1278690186247062,-1,-3,-2,2,-1,2,1,2,-2,-2,1,2.071699999999255
6,R_2Si8iSDiTMldrAB,44,j,2,0,15693,Remove police from schools,Student worker unionization,-1,1,1,2,4,0.31874559222002574,3,5,4,1.1278690186247062,-1,3,4,2,3,4,3,-4,4,-2,1,15.693
6,R_2Si8iSDiTMldrAB,45,f,1,1,10066.5,Student worker unionization,Abolishing fraternities,-1,-1,3,5,4,1.1278690186247062,1,4,3,0.31874559222002574,-3,-1,-2,2,1,2,1,-2,2,2,0,10.0665
6,R_2Si8iSDiTMldrAB,46,j,2,0,5085.299999998882,Abortion rights,Hardening schools/Arming teachers,1,-1,3,8,4,1.1278690186247062,-3,6,4,-1.2995012605893355,3,3,0,-6,-2,0,2,0,0,6,1,5.085299999998883
6,R_2Si8iSDiTMldrAB,47,f,1,1,1864.199999999255,Stop police brutality,Dorms determined by gender identity,1,1,3,8,4,1.1278690186247062,-2,4,1,-0.8949395473869951,3,-2,5,5,4,5,4,5,-5,5,0,1.864199999999255
6,R_2Si8iSDiTMldrAB,48,j,2,0,2238,Remove police from schools,Student worker unionization,-1,-1,1,2,4,0.31874559222002574,3,5,4,1.1278690186247062,-1,-3,-2,2,3,2,3,2,-2,-2,1,2.238
6,R_2Si8iSDiTMldrAB,49,j,2,0,22640.300000000745,Student worker unionization,Gun-free campus police,1,1,3,5,4,1.1278690186247062,0,4,3,-0.08581612098231453,3,0,-3,-3,-1,3,1,3,-3,3,1,22.640300000000746
6,R_2Si8iSDiTMldrAB,50,j,2,0,9815.5,Ban on ethnic Halloween costumes,Expel students with white nationlist views,-1,1,0,0,2,-0.08581612098231453,3,8,4,1.1278690186247062,-0,3,3,3,8,3,8,-3,3,-3,1,9.8155
6,R_2Si8iSDiTMldrAB,51,j,2,0,3806,Expel students with white nationlist views,Abolishing fraternities,-1,-1,3,8,4,1.1278690186247062,1,4,3,0.31874559222002574,-3,-1,2,-2,-4,2,4,-2,2,2,1,3.806
6,R_2Si8iSDiTMldrAB,52,j,2,0,2748,On campus concealed carry,Student worker unionization,-1,-1,1,1,3,0.31874559222002574,3,5,4,1.1278690186247062,-1,-3,-2,2,4,2,4,2,-2,-2,1,2.748
6,R_2Si8iSDiTMldrAB,53,j,2,0,4204,Student worker unionization,Mandatory vaccinations,1,1,3,5,4,1.1278690186247062,1,6,3,0.31874559222002574,3,1,-2,-2,1,2,1,2,-2,2,1,4.204
6,R_2Si8iSDiTMldrAB,54,f,1,1,2293.800000000745,Climate change legislation,Ban on ethnic Halloween costumes,-1,-1,3,8,3,1.1278690186247062,0,0,2,-0.08581612098231453,-3,-0,-3,3,8,3,8,-3,3,3,0,2.2938000000007452
6,R_2Si8iSDiTMldrAB,55,j,2,0,3699.4000000003725,Student worker unionization,Defund Planned Parenthood,-1,-1,3,5,4,1.1278690186247062,-3,7,2,-1.2995012605893355,-3,3,6,-6,2,6,2,-6,6,6,1,3.6994000000003724
6,R_2Si8iSDiTMldrAB,56,f,1,1,2328.199999999255,Mandatory vaccinations,Student worker unionization,1,-1,1,6,3,0.31874559222002574,3,5,4,1.1278690186247062,1,-3,4,-2,1,4,1,4,-4,-2,0,2.328199999999255
6,R_2Si8iSDiTMldrAB,57,j,2,0,6890.300000000745,Ban on ethnic Halloween costumes,Student worker unionization,1,1,0,0,2,-0.08581612098231453,3,5,4,1.1278690186247062,0,3,3,3,5,3,5,-3,3,-3,1,6.890300000000745
6,R_2Si8iSDiTMldrAB,58,f,1,1,2708.9000000003725,Mandatory drug tests for welfare recipients,Build southern border wall,1,1,-3,6,3,-1.2995012605893355,-3,8,4,-1.2995012605893355,-3,-3,0,0,-2,0,2,0,0,0,0,2.7089000000003725
6,R_2Si8iSDiTMldrAB,59,f,1,1,5440.4000000003725,Remove public Confederate memorials,On campus concealed carry,1,-1,3,8,4,1.1278690186247062,1,1,3,0.31874559222002574,3,-1,4,2,7,4,7,4,-4,2,0,5.4404000000003725
6,R_2Si8iSDiTMldrAB,60,f,1,1,2943.7000000011176,Abolishing fraternities,Student worker unionization,1,-1,1,4,3,0.31874559222002574,3,5,4,1.1278690186247062,1,-3,4,-2,-1,4,1,4,-4,-2,0,2.9437000000011175
6,R_2Si8iSDiTMldrAB,61,j,2,0,2292.699999999255,Expel students with white nationlist views,Bathrooms restricted based on biological sex,1,-1,3,8,4,1.1278690186247062,-3,4,4,-1.2995012605893355,3,3,0,-6,-4,0,4,0,0,6,1,2.292699999999255
6,R_2Si8iSDiTMldrAB,62,f,1,1,8397.300000000745,Build southern border wall,Abolishing fraternities,-1,-1,-3,8,4,-1.2995012605893355,1,4,3,0.31874559222002574,3,-1,4,-4,4,4,4,4,-4,-4,0,8.397300000000746
6,R_2Si8iSDiTMldrAB,63,j,2,0,4881,Mandatory vaccinations,Abortion rights,-1,1,1,6,3,0.31874559222002574,3,8,4,1.1278690186247062,-1,3,4,2,2,4,2,-4,4,-2,1,4.881
6,R_2Si8iSDiTMldrAB,64,f,1,1,18894.400000000373,Abolishing private prisons,Expel students with white nationlist views,1,-1,3,8,4,1.1278690186247062,3,8,4,1.1278690186247062,3,-3,6,0,0,6,0,6,-6,0,0,18.894400000000374
6,R_2Si8iSDiTMldrAB,65,j,2,0,1811.300000000745,Abolishing fraternities,Student worker unionization,-1,1,1,4,3,0.31874559222002574,3,5,4,1.1278690186247062,-1,3,4,2,1,4,1,-4,4,-2,1,1.811300000000745
6,R_2Si8iSDiTMldrAB,66,f,1,1,5420.4000000003725,Student worker unionization,Mandatory trigger warnings,1,-1,3,5,4,1.1278690186247062,2,5,3,0.7233073054223661,3,-2,5,1,0,5,0,5,-5,1,0,5.420400000000373
6,R_2Si8iSDiTMldrAB,67,j,2,0,17574,Climate change legislation,War on Drugs,-1,-1,3,8,3,1.1278690186247062,-3,7,4,-1.2995012605893355,-3,3,6,-6,-1,6,1,-6,6,6,1,17.574
6,R_2Si8iSDiTMldrAB,68,j,2,0,36161.800000000745,Remove police from schools,Remove public Confederate memorials,-1,1,1,2,4,0.31874559222002574,3,8,4,1.1278690186247062,-1,3,4,2,6,4,6,-4,4,-2,1,36.161800000000746
6,R_2Si8iSDiTMldrAB,69,j,2,0,7428.200000001118,Mandatory trigger warnings,Student worker unionization,-1,-1,2,5,3,0.7233073054223661,3,5,4,1.1278690186247062,-2,-3,-1,1,0,1,0,1,-1,-1,1,7.428200000001118
6,R_2Si8iSDiTMldrAB,70,f,1,1,7280.4000000003725,Mandatory vaccinations,Remove public Confederate memorials,1,-1,1,6,3,0.31874559222002574,3,8,4,1.1278690186247062,1,-3,4,-2,-2,4,2,4,-4,-2,0,7.280400000000372
6,R_2Si8iSDiTMldrAB,71,f,1,1,12497.5,Ban on research with animals,Black Lives Matter,-1,-1,-1,0,3,-0.4903778341846548,3,8,4,1.1278690186247062,1,-3,4,-4,-8,4,8,4,-4,-4,0,12.4975
6,R_2Si8iSDiTMldrAB,72,j,2,0,5546.699999999255,Student worker unionization,Stop police brutality,-1,1,3,5,4,1.1278690186247062,3,8,4,1.1278690186247062,-3,3,6,0,3,6,3,-6,6,0,1,5.546699999999255
6,R_2Si8iSDiTMldrAB,73,j,2,0,25141.400000000373,Abolishing private prisons,Mandatory trigger warnings,-1,1,3,8,4,1.1278690186247062,2,5,3,0.7233073054223661,-3,2,5,-1,-3,5,3,-5,5,1,1,25.141400000000374
6,R_2Si8iSDiTMldrAB,74,j,2,0,2246.800000000745,Student worker unionization,Expel students with white nationlist views,1,1,3,5,4,1.1278690186247062,3,8,4,1.1278690186247062,3,3,0,0,3,0,3,0,0,0,1,2.246800000000745
6,R_2Si8iSDiTMldrAB,75,f,1,1,2508,Raise the minimum wage,On campus concealed carry,1,1,3,8,4,1.1278690186247062,1,1,3,0.31874559222002574,3,1,2,2,7,2,7,2,-2,2,0,2.508
6,R_2Si8iSDiTMldrAB,76,f,1,1,1624.0999999996275,Affirmative action,Student worker unionization,1,-1,2,4,3,0.7233073054223661,3,5,4,1.1278690186247062,2,-3,5,-1,-1,5,1,5,-5,-1,0,1.6240999999996275
6,R_2Si8iSDiTMldrAB,77,f,1,1,3016.699999999255,Build southern border wall,Mandatory vaccinations,1,-1,-3,8,4,-1.2995012605893355,1,6,3,0.31874559222002574,-3,-1,-2,-4,2,2,2,-2,2,-4,0,3.016699999999255
6,R_2Si8iSDiTMldrAB,78,j,2,0,3566.60000000149,Affirmative action,Abolishing private prisons,1,1,2,4,3,0.7233073054223661,3,8,4,1.1278690186247062,2,3,1,1,4,1,4,-1,1,-1,1,3.56660000000149
6,R_2Si8iSDiTMldrAB,79,j,2,0,9812,Abortion rights,Increased Gun regulations,-1,-1,3,8,4,1.1278690186247062,2,6,3,0.7233073054223661,-3,-2,1,-1,-2,1,2,-1,1,1,1,9.812
6,R_2Si8iSDiTMldrAB,80,f,1,1,4029.800000000745,Raise the minimum wage,Mandatory trigger warnings,1,-1,3,8,4,1.1278690186247062,2,5,3,0.7233073054223661,3,-2,5,1,3,5,3,5,-5,1,0,4.029800000000745
6,R_2Si8iSDiTMldrAB,81,j,2,0,10168,Bathrooms restricted based on biological sex,Student worker unionization,1,1,-3,4,4,-1.2995012605893355,3,5,4,1.1278690186247062,-3,3,6,6,1,6,1,-6,6,-6,1,10.168
6,R_2Si8iSDiTMldrAB,82,f,1,1,8563.10000000149,Remove police from schools,Raise the minimum wage,1,-1,1,2,4,0.31874559222002574,3,8,4,1.1278690186247062,1,-3,4,-2,-6,4,6,4,-4,-2,0,8.56310000000149
6,R_2Si8iSDiTMldrAB,83,j,2,0,9510.699999999255,Student worker unionization,Hardening schools/Arming teachers,1,1,3,5,4,1.1278690186247062,-3,6,4,-1.2995012605893355,3,-3,-6,-6,1,6,1,6,-6,6,1,9.510699999999256
6,R_2Si8iSDiTMldrAB,84,j,2,0,2557.4000000003725,Increased Gun regulations,Student worker unionization,-1,1,2,6,3,0.7233073054223661,3,5,4,1.1278690186247062,-2,3,5,1,-1,5,1,-5,5,-1,1,2.5574000000003725
6,R_2Si8iSDiTMldrAB,85,f,1,1,2570.5999999996275,Raise the minimum wage,Abolishing fraternities,1,1,3,8,4,1.1278690186247062,1,4,3,0.31874559222002574,3,1,2,2,4,2,4,2,-2,2,0,2.5705999999996276
6,R_2Si8iSDiTMldrAB,86,j,2,0,5130.700000001118,Mandatory trigger warnings,Stop police brutality,1,1,2,5,3,0.7233073054223661,3,8,4,1.1278690186247062,2,3,1,1,3,1,3,-1,1,-1,1,5.130700000001117
6,R_2Si8iSDiTMldrAB,87,j,2,0,1905.4000000003725,Expel students with white nationlist views,Student worker unionization,-1,-1,3,8,4,1.1278690186247062,3,5,4,1.1278690186247062,-3,-3,0,0,-3,0,3,0,0,0,1,1.9054000000003726
6,R_2Si8iSDiTMldrAB,88,f,1,1,1316.199999999255,Dorms determined by gender identity,Abortion rights,1,-1,-2,4,1,-0.8949395473869951,3,8,4,1.1278690186247062,-2,-3,1,-5,-4,1,4,1,-1,-5,0,1.3161999999992549
6,R_2Si8iSDiTMldrAB,89,f,1,1,3787.5999999996275,Increased Gun regulations,Student worker unionization,1,-1,2,6,3,0.7233073054223661,3,5,4,1.1278690186247062,2,-3,5,-1,1,5,1,5,-5,-1,0,3.7875999999996273
6,R_2Si8iSDiTMldrAB,90,j,2,0,1790.699999999255,Increased Gun regulations,Abolishing private prisons,1,1,2,6,3,0.7233073054223661,3,8,4,1.1278690186247062,2,3,1,1,2,1,2,-1,1,-1,1,1.790699999999255
6,R_2Si8iSDiTMldrAB,91,j,2,0,3593.10000000149,Climate change legislation,Mandatory drug tests for welfare recipients,-1,-1,3,8,3,1.1278690186247062,-3,6,3,-1.2995012605893355,-3,3,6,-6,-2,6,2,-6,6,6,1,3.59310000000149
6,R_2Si8iSDiTMldrAB,92,j,2,0,4699.9000000003725,Mandatory vaccinations,Raise the minimum wage,1,1,1,6,3,0.31874559222002574,3,8,4,1.1278690186247062,1,3,2,2,2,2,2,-2,2,-2,1,4.699900000000373
6,R_2Si8iSDiTMldrAB,93,f,1,1,3144.800000000745,Gun-free campus police,Stop police brutality,1,-1,0,4,3,-0.08581612098231453,3,8,4,1.1278690186247062,0,-3,3,-3,-4,3,4,3,-3,-3,0,3.1448000000007452
6,R_2Si8iSDiTMldrAB,94,f,1,1,1231.7000000011176,Bathrooms restricted based on biological sex,Student worker unionization,-1,-1,-3,4,4,-1.2995012605893355,3,5,4,1.1278690186247062,3,-3,6,-6,-1,6,1,6,-6,-6,0,1.2317000000011176
6,R_2Si8iSDiTMldrAB,95,j,2,0,4814.4000000003725,Gun-free campus police,Abolishing private prisons,1,1,0,4,3,-0.08581612098231453,3,8,4,1.1278690186247062,0,3,3,3,4,3,4,-3,3,-3,1,4.814400000000372
6,R_2Si8iSDiTMldrAB,96,j,2,0,2543.800000000745,Remove police from schools,Expel students with white nationlist views,1,1,1,2,4,0.31874559222002574,3,8,4,1.1278690186247062,1,3,2,2,6,2,6,-2,2,-2,1,2.5438000000007452
6,R_2Si8iSDiTMldrAB,97,f,1,1,1235.9000000003725,Bathrooms restricted based on biological sex,Student worker unionization,-1,1,-3,4,4,-1.2995012605893355,3,5,4,1.1278690186247062,3,3,0,-6,-1,0,1,0,0,-6,0,1.2359000000003726
6,R_2Si8iSDiTMldrAB,98,f,1,1,2230.5,Abolishing fraternities,Student worker unionization,1,1,1,4,3,0.31874559222002574,3,5,4,1.1278690186247062,1,3,-2,-2,-1,2,1,-2,2,-2,0,2.2305
6,R_2Si8iSDiTMldrAB,99,f,1,1,4052,Stop police brutality,Ban on research with animals,1,-1,3,8,4,1.1278690186247062,-1,0,3,-0.4903778341846548,3,1,2,4,8,2,8,2,-2,4,0,4.052
6,R_2Si8iSDiTMldrAB,100,f,1,1,8551.400000000373,Mandatory drug tests for welfare recipients,Student worker unionization,-1,1,-3,6,3,-1.2995012605893355,3,5,4,1.1278690186247062,3,3,0,-6,1,0,1,0,0,-6,0,8.551400000000372
1,R_1eEotFgXgjm2k7Z,1,f,1,1,2815.2999999523163,Mandatory trigger warnings,Remove police from schools,-1,1,-2,0,2,-0.6081655365649388,-3,5,2,-1.029203215725281,2,-3,5,1,-5,5,5,5,-5,1,0,2.8152999999523165
1,R_1eEotFgXgjm2k7Z,2,f,1,1,1891.1000000238419,Mandatory drug tests for welfare recipients,Mandatory trigger warnings,1,1,3,6,3,1.4970228592367723,-2,0,2,-0.6081655365649388,3,-2,5,5,6,5,6,5,-5,5,0,1.8911000000238418
1,R_1eEotFgXgjm2k7Z,3,j,2,0,6650.599999904633,Stop police brutality,Gun-free campus police,1,1,3,5,3,1.4970228592367723,-2,3,1,-0.6081655365649388,3,-2,-5,-5,-2,5,2,5,-5,5,1,6.650599999904633
1,R_1eEotFgXgjm2k7Z,4,f,1,1,2761.0999999046326,Black Lives Matter,Raise the minimum wage,-1,1,-2,7,3,-0.6081655365649388,-3,5,4,-1.029203215725281,2,-3,5,1,2,5,2,5,-5,1,0,2.7610999999046326
1,R_1eEotFgXgjm2k7Z,5,j,2,0,4517.699999928474,Affirmative action,Raise the minimum wage,1,1,-2,5,3,-0.6081655365649388,-3,5,4,-1.029203215725281,-2,-3,-1,-1,0,1,0,1,-1,1,1,4.517699999928475
1,R_1eEotFgXgjm2k7Z,6,f,1,1,3312.2000000476837,Ban on research with animals,Mandatory drug tests for welfare recipients,1,-1,2,6,3,1.07598518007643,3,6,3,1.4970228592367723,2,-3,5,-1,0,5,0,5,-5,-1,0,3.312200000047684
1,R_1eEotFgXgjm2k7Z,7,j,2,0,7201.899999976158,Lift COVID lockdowns,Mask mandates,-1,1,3,5,3,1.4970228592367723,-3,3,4,-1.029203215725281,-3,-3,0,-6,-2,0,2,0,0,6,1,7.201899999976158
1,R_1eEotFgXgjm2k7Z,8,j,2,0,5601,Mandatory trigger warnings,Mandatory drug tests for welfare recipients,-1,1,-2,0,2,-0.6081655365649388,3,6,3,1.4970228592367723,2,3,1,5,6,1,6,-1,1,-5,1,5.601
1,R_1eEotFgXgjm2k7Z,9,f,1,1,2373.899999976158,Mandatory drug tests for welfare recipients,Affirmative action,1,1,3,6,3,1.4970228592367723,-2,5,3,-0.6081655365649388,3,-2,5,5,1,5,1,5,-5,5,0,2.373899999976158
1,R_1eEotFgXgjm2k7Z,10,j,2,0,3915.5,Abolishing fraternities,Remove Christopher Columbus statues,1,-1,-2,2,1,-0.6081655365649388,-3,5,2,-1.029203215725281,-2,3,5,-1,3,5,3,-5,5,1,1,3.9155
1,R_1eEotFgXgjm2k7Z,11,f,1,1,3460.7999999523163,Mandatory vaccinations,Mandatory drug tests for welfare recipients,-1,-1,-3,8,4,-1.029203215725281,3,6,3,1.4970228592367723,3,-3,6,-6,2,6,2,6,-6,-6,0,3.4607999999523162
1,R_1eEotFgXgjm2k7Z,12,j,2,0,3350.6999999284744,War on Drugs,Mandatory drug tests for welfare recipients,-1,1,3,7,4,1.4970228592367723,3,6,3,1.4970228592367723,-3,3,6,0,-1,6,1,-6,6,0,1,3.3506999999284743
1,R_1eEotFgXgjm2k7Z,13,j,2,0,4227.200000047684,Raise the minimum wage,Hardening schools/Arming teachers,1,1,-3,5,4,-1.029203215725281,1,1,1,0.6549475009160878,-3,1,4,4,-4,4,4,-4,4,-4,1,4.2272000000476835
1,R_1eEotFgXgjm2k7Z,14,f,1,1,7418.899999976158,Mandatory drug tests for welfare recipients,Abortion rights,1,1,3,6,3,1.4970228592367723,2,1,4,1.07598518007643,3,2,1,1,5,1,5,1,-1,1,0,7.4188999999761585
1,R_1eEotFgXgjm2k7Z,15,j,2,0,2407.5,Legalization of marijuana,Climate change legislation,1,-1,-3,5,3,-1.029203215725281,-2,1,2,-0.6081655365649388,-3,2,5,1,-4,5,4,-5,5,-1,1,2.4075
1,R_1eEotFgXgjm2k7Z,16,j,2,0,3570.899999976158,Stop police brutality,War on Drugs,1,1,3,5,3,1.4970228592367723,3,7,4,1.4970228592367723,3,3,0,0,2,0,2,0,0,0,1,3.570899999976158
1,R_1eEotFgXgjm2k7Z,17,j,2,0,5342.899999976158,Legalization of marijuana,Mask mandates,-1,-1,-3,5,3,-1.029203215725281,-3,3,4,-1.029203215725281,3,3,0,0,-2,0,2,0,0,0,1,5.342899999976158
1,R_1eEotFgXgjm2k7Z,18,j,2,0,6208.399999976158,Raise the minimum wage,Remove public Confederate memorials,-1,-1,-3,5,4,-1.029203215725281,-3,4,2,-1.029203215725281,3,3,0,0,-1,0,1,0,0,0,1,6.208399999976158
1,R_1eEotFgXgjm2k7Z,19,j,2,0,6206.700000047684,Lift COVID lockdowns,Hardening schools/Arming teachers,-1,-1,3,5,3,1.4970228592367723,1,1,1,0.6549475009160878,-3,-1,2,-2,-4,2,4,-2,2,2,1,6.206700000047683
1,R_1eEotFgXgjm2k7Z,20,f,1,1,5439.900000095367,Mandatory drug tests for welfare recipients,Hardening schools/Arming teachers,1,1,3,6,3,1.4970228592367723,1,1,1,0.6549475009160878,3,1,2,2,5,2,5,2,-2,2,0,5.439900000095367
1,R_1eEotFgXgjm2k7Z,21,j,2,0,3790.2000000476837,Mandatory vaccinations,Mandatory drug tests for welfare recipients,1,1,-3,8,4,-1.029203215725281,3,6,3,1.4970228592367723,-3,3,6,6,-2,6,2,-6,6,-6,1,3.7902000000476836
1,R_1eEotFgXgjm2k7Z,22,f,1,1,3782.2000000476837,Raise the minimum wage,Affirmative action,-1,1,-3,5,4,-1.029203215725281,-2,5,3,-0.6081655365649388,3,-2,5,-1,0,5,0,5,-5,-1,0,3.7822000000476836
1,R_1eEotFgXgjm2k7Z,23,f,1,1,7394.700000047684,Remove police from schools,Climate change legislation,-1,1,-3,5,2,-1.029203215725281,-2,1,2,-0.6081655365649388,3,-2,5,-1,4,5,4,5,-5,-1,0,7.394700000047684
1,R_1eEotFgXgjm2k7Z,24,f,1,1,5368.799999952316,Mandatory drug tests for welfare recipients,Abolishing fraternities,-1,1,3,6,3,1.4970228592367723,-2,2,1,-0.6081655365649388,-3,-2,-1,5,4,1,4,-1,1,5,0,5.368799999952317
1,R_1eEotFgXgjm2k7Z,25,j,2,0,2383.3000000715256,Mandatory drug tests for welfare recipients,War on Drugs,-1,1,3,6,3,1.4970228592367723,3,7,4,1.4970228592367723,-3,3,6,0,1,6,1,-6,6,0,1,2.3833000000715256
1,R_1eEotFgXgjm2k7Z,26,f,1,1,8814.399999976158,Remove Christopher Columbus statues,Hardening schools/Arming teachers,-1,-1,-3,5,2,-1.029203215725281,1,1,1,0.6549475009160878,3,-1,4,-4,4,4,4,4,-4,-4,0,8.814399999976159
1,R_1eEotFgXgjm2k7Z,27,f,1,1,2489.100000023842,Lift COVID lockdowns,Increased Gun regulations,-1,1,3,5,3,1.4970228592367723,-2,6,3,-0.6081655365649388,-3,-2,-1,5,-1,1,1,-1,1,5,0,2.489100000023842
1,R_1eEotFgXgjm2k7Z,28,f,1,1,3685,Mandatory drug tests for welfare recipients,Ban on research with animals,1,1,3,6,3,1.4970228592367723,2,6,3,1.07598518007643,3,2,1,1,0,1,0,1,-1,1,0,3.685
1,R_1eEotFgXgjm2k7Z,29,j,2,0,5673.399999976158,Mandatory training on sexual consent,Remove police from schools,1,-1,0,0,1,0.2339098217557456,-3,5,2,-1.029203215725281,0,3,3,-3,5,3,5,-3,3,3,1,5.673399999976158
1,R_1eEotFgXgjm2k7Z,30,f,1,1,9611.300000071526,Mask mandates,Stop police brutality,1,1,-3,3,4,-1.029203215725281,3,5,3,1.4970228592367723,-3,3,-6,-6,-2,6,2,-6,6,-6,0,9.611300000071525
1,R_1eEotFgXgjm2k7Z,31,f,1,1,3781.899999976158,Defund Planned Parenthood,Remove police from schools,-1,1,1,6,1,0.6549475009160878,-3,5,2,-1.029203215725281,-1,-3,2,4,1,2,1,2,-2,4,0,3.781899999976158
1,R_1eEotFgXgjm2k7Z,32,f,1,1,3534.7000000476837,Affirmative action,Remove police from schools,-1,-1,-2,5,3,-0.6081655365649388,-3,5,2,-1.029203215725281,2,3,-1,1,0,1,0,-1,1,1,0,3.5347000000476836
1,R_1eEotFgXgjm2k7Z,33,f,1,1,4353,Mandatory drug tests for welfare recipients,Ban on research with animals,1,-1,3,6,3,1.4970228592367723,2,6,3,1.07598518007643,3,-2,5,1,0,5,0,5,-5,1,0,4.353
1,R_1eEotFgXgjm2k7Z,34,f,1,1,10291,Affirmative action,Stop police brutality,-1,-1,-2,5,3,-0.6081655365649388,3,5,3,1.4970228592367723,2,-3,5,-5,0,5,0,5,-5,-5,0,10.291
1,R_1eEotFgXgjm2k7Z,35,j,2,0,4059.6999999284744,Mandatory drug tests for welfare recipients,Lift COVID lockdowns,-1,-1,3,6,3,1.4970228592367723,3,5,3,1.4970228592367723,-3,-3,0,0,-1,0,1,0,0,0,1,4.059699999928474
1,R_1eEotFgXgjm2k7Z,36,f,1,1,3168.100000023842,Mandatory drug tests for welfare recipients,Defund Planned Parenthood,1,1,3,6,3,1.4970228592367723,1,6,1,0.6549475009160878,3,1,2,2,0,2,0,2,-2,2,0,3.1681000000238417
1,R_1eEotFgXgjm2k7Z,37,j,2,0,3242.2000000476837,Mandatory trigger warnings,Remove Christopher Columbus statues,-1,-1,-2,0,2,-0.6081655365649388,-3,5,2,-1.029203215725281,2,3,1,-1,5,1,5,-1,1,1,1,3.2422000000476836
1,R_1eEotFgXgjm2k7Z,38,f,1,1,3945.399999976158,Mandatory drug tests for welfare recipients,Recognize Jerusalem as capital of Israel,1,-1,3,6,3,1.4970228592367723,1,1,1,0.6549475009160878,3,-1,4,2,5,4,5,4,-4,2,0,3.945399999976158
1,R_1eEotFgXgjm2k7Z,39,j,2,0,3377.6999999284744,Mandatory trigger warnings,Raise the minimum wage,1,1,-2,0,2,-0.6081655365649388,-3,5,4,-1.029203215725281,-2,-3,-1,-1,5,1,5,1,-1,1,1,3.3776999999284745
1,R_1eEotFgXgjm2k7Z,40,f,1,1,3868.600000023842,Raise the minimum wage,Mandatory trigger warnings,-1,1,-3,5,4,-1.029203215725281,-2,0,2,-0.6081655365649388,3,-2,5,-1,5,5,5,5,-5,-1,0,3.868600000023842
1,R_1eEotFgXgjm2k7Z,41,j,2,0,5607.399999976158,Stop police brutality,Defund Planned Parenthood,-1,1,3,5,3,1.4970228592367723,1,6,1,0.6549475009160878,-3,1,4,-2,1,4,1,-4,4,2,1,5.607399999976158
1,R_1eEotFgXgjm2k7Z,42,j,2,0,3317.2000000476837,Abolishing fraternities,Remove Christopher Columbus statues,-1,-1,-2,2,1,-0.6081655365649388,-3,5,2,-1.029203215725281,2,3,1,-1,3,1,3,-1,1,1,1,3.317200000047684
1,R_1eEotFgXgjm2k7Z,43,j,2,0,6267.800000071526,Black Lives Matter,Mandatory drug tests for welfare recipients,1,1,-2,7,3,-0.6081655365649388,3,6,3,1.4970228592367723,-2,3,5,5,-1,5,1,-5,5,-5,1,6.267800000071525
1,R_1eEotFgXgjm2k7Z,44,f,1,1,2373.600000023842,Mandatory drug tests for welfare recipients,Mask mandates,1,1,3,6,3,1.4970228592367723,-3,3,4,-1.029203215725281,3,-3,6,6,3,6,3,6,-6,6,0,2.373600000023842
1,R_1eEotFgXgjm2k7Z,45,j,2,0,4179.700000047684,Affirmative action,Mandatory drug tests for welfare recipients,-1,1,-2,5,3,-0.6081655365649388,3,6,3,1.4970228592367723,2,3,1,5,1,1,1,-1,1,-5,1,4.179700000047684
1,R_1eEotFgXgjm2k7Z,46,j,2,0,3205.2999999523163,On campus concealed carry,Mandatory drug tests for welfare recipients,1,1,2,2,1,1.07598518007643,3,6,3,1.4970228592367723,2,3,1,1,4,1,4,-1,1,-1,1,3.205299999952316
1,R_1eEotFgXgjm2k7Z,47,j,2,0,3799.0999999046326,Remove police from schools,Lift COVID lockdowns,1,1,-3,5,2,-1.029203215725281,3,5,3,1.4970228592367723,-3,3,6,6,0,6,0,-6,6,-6,1,3.7990999999046324
1,R_1eEotFgXgjm2k7Z,48,f,1,1,3486,Mandatory drug tests for welfare recipients,Black Lives Matter,1,-1,3,6,3,1.4970228592367723,-2,7,3,-0.6081655365649388,3,2,1,5,-1,1,1,1,-1,5,0,3.486
1,R_1eEotFgXgjm2k7Z,49,j,2,0,4620.799999952316,Remove police from schools,Abolishing fraternities,1,1,-3,5,2,-1.029203215725281,-2,2,1,-0.6081655365649388,-3,-2,1,1,-3,1,3,-1,1,-1,1,4.620799999952316
1,R_1eEotFgXgjm2k7Z,50,j,2,0,3556.600000023842,Raise the minimum wage,Mask mandates,1,-1,-3,5,4,-1.029203215725281,-3,3,4,-1.029203215725281,-3,3,6,0,-2,6,2,-6,6,0,1,3.556600000023842
1,R_1eEotFgXgjm2k7Z,51,f,1,1,4875.199999928474,Remove public Confederate memorials,Mandatory drug tests for welfare recipients,-1,-1,-3,4,2,-1.029203215725281,3,6,3,1.4970228592367723,3,-3,6,-6,-2,6,2,6,-6,-6,0,4.8751999999284745
1,R_1eEotFgXgjm2k7Z,52,f,1,1,4418.300000071526,Lift COVID lockdowns,Remove public Confederate memorials,-1,1,3,5,3,1.4970228592367723,-3,4,2,-1.029203215725281,-3,-3,0,6,1,0,1,0,0,6,0,4.418300000071525
1,R_1eEotFgXgjm2k7Z,53,j,2,0,3934.899999976158,Remove police from schools,Mandatory drug tests for welfare recipients,-1,-1,-3,5,2,-1.029203215725281,3,6,3,1.4970228592367723,3,-3,-6,6,1,6,1,6,-6,-6,1,3.934899999976158
1,R_1eEotFgXgjm2k7Z,54,j,2,0,5062,Defund Planned Parenthood,Remove police from schools,-1,-1,1,6,1,0.6549475009160878,-3,5,2,-1.029203215725281,-1,3,4,-4,-1,4,1,-4,4,4,1,5.062
1,R_1eEotFgXgjm2k7Z,55,j,2,0,3842.899999976158,Physician-assisted suicide,Lift COVID lockdowns,-1,-1,2,3,3,1.07598518007643,3,5,3,1.4970228592367723,-2,-3,-1,1,2,1,2,1,-1,-1,1,3.842899999976158
1,R_1eEotFgXgjm2k7Z,56,j,2,0,6701.699999928474,Abortion rights,Mandatory drug tests for welfare recipients,-1,1,2,1,4,1.07598518007643,3,6,3,1.4970228592367723,-2,3,5,1,5,5,5,-5,5,-1,1,6.701699999928475
1,R_1eEotFgXgjm2k7Z,57,f,1,1,3426.5,Mandatory vaccinations,Mandatory drug tests for welfare recipients,-1,1,-3,8,4,-1.029203215725281,3,6,3,1.4970228592367723,3,3,0,-6,2,0,2,0,0,-6,0,3.4265
1,R_1eEotFgXgjm2k7Z,58,f,1,1,3745,Mandatory drug tests for welfare recipients,Mandatory vaccinations,-1,1,3,6,3,1.4970228592367723,-3,8,4,-1.029203215725281,-3,-3,0,6,-2,0,2,0,0,6,0,3.745
1,R_1eEotFgXgjm2k7Z,59,f,1,1,3673.100000023842,Mandatory drug tests for welfare recipients,Ban on research with animals,-1,-1,3,6,3,1.4970228592367723,2,6,3,1.07598518007643,-3,-2,-1,1,0,1,0,-1,1,1,0,3.673100000023842
1,R_1eEotFgXgjm2k7Z,60,j,2,0,7120.200000047684,Remove Christopher Columbus statues,Mandatory drug tests for welfare recipients,-1,1,-3,5,2,-1.029203215725281,3,6,3,1.4970228592367723,3,3,0,6,1,0,1,0,0,-6,1,7.120200000047683
1,R_1eEotFgXgjm2k7Z,61,f,1,1,5663.200000047684,Gun-free campus police,Mandatory drug tests for welfare recipients,-1,-1,-2,3,1,-0.6081655365649388,3,6,3,1.4970228592367723,2,-3,5,-5,-3,5,3,5,-5,-5,0,5.663200000047683
1,R_1eEotFgXgjm2k7Z,62,f,1,1,2752.2999999523163,Mandatory drug tests for welfare recipients,Abolishing fraternities,1,1,3,6,3,1.4970228592367723,-2,2,1,-0.6081655365649388,3,-2,5,5,4,5,4,5,-5,5,0,2.7522999999523163
1,R_1eEotFgXgjm2k7Z,63,f,1,1,4034.399999976158,Stop police brutality,Defund the police,1,1,3,5,3,1.4970228592367723,-3,8,3,-1.029203215725281,3,-3,6,6,-3,6,3,6,-6,6,0,4.034399999976158
1,R_1eEotFgXgjm2k7Z,64,f,1,1,4173.399999976158,Remove police from schools,Black Lives Matter,1,1,-3,5,2,-1.029203215725281,-2,7,3,-0.6081655365649388,-3,-2,-1,-1,-2,1,2,-1,1,-1,0,4.173399999976158
1,R_1eEotFgXgjm2k7Z,65,j,2,0,4754.700000047684,Physician-assisted suicide,Mandatory drug tests for welfare recipients,1,1,2,3,3,1.07598518007643,3,6,3,1.4970228592367723,2,3,1,1,3,1,3,-1,1,-1,1,4.754700000047683
1,R_1eEotFgXgjm2k7Z,66,f,1,1,2730.899999976158,Physician-assisted suicide,Lift COVID lockdowns,1,-1,2,3,3,1.07598518007643,3,5,3,1.4970228592367723,2,-3,5,-1,-2,5,2,5,-5,-1,0,2.7308999999761583
1,R_1eEotFgXgjm2k7Z,67,f,1,1,1910.5,Mandatory drug tests for welfare recipients,Gun-free campus police,1,1,3,6,3,1.4970228592367723,-2,3,1,-0.6081655365649388,3,-2,5,5,3,5,3,5,-5,5,0,1.9105
1,R_1eEotFgXgjm2k7Z,68,j,2,0,13557.199999928474,Legalization of marijuana,Defund the police,1,-1,-3,5,3,-1.029203215725281,-3,8,3,-1.029203215725281,-3,3,6,0,3,6,3,-6,6,0,1,13.557199999928475
1,R_1eEotFgXgjm2k7Z,69,j,2,0,2767.1999999284744,Raise the minimum wage,Defund the police,-1,-1,-3,5,4,-1.029203215725281,-3,8,3,-1.029203215725281,3,3,0,0,3,0,3,0,0,0,1,2.7671999999284744
1,R_1eEotFgXgjm2k7Z,70,f,1,1,2940.7000000476837,Mandatory drug tests for welfare recipients,Mandatory training on sexual consent,1,1,3,6,3,1.4970228592367723,0,0,1,0.2339098217557456,3,0,3,3,6,3,6,3,-3,3,0,2.9407000000476837
1,R_1eEotFgXgjm2k7Z,71,f,1,1,5414.600000023842,Mask mandates,Mandatory drug tests for welfare recipients,-1,-1,-3,3,4,-1.029203215725281,3,6,3,1.4970228592367723,3,-3,6,-6,-3,6,3,6,-6,-6,0,5.4146000000238415
1,R_1eEotFgXgjm2k7Z,72,f,1,1,3178.3000000715256,Mandatory drug tests for welfare recipients,Remove public Confederate memorials,-1,1,3,6,3,1.4970228592367723,-3,4,2,-1.029203215725281,-3,-3,0,6,2,0,2,0,0,6,0,3.1783000000715256
1,R_1eEotFgXgjm2k7Z,73,j,2,0,4568.5,Mask mandates,Mandatory drug tests for welfare recipients,-1,1,-3,3,4,-1.029203215725281,3,6,3,1.4970228592367723,3,3,0,6,3,0,3,0,0,-6,1,4.5685
1,R_1eEotFgXgjm2k7Z,74,f,1,1,3164.5,Mandatory drug tests for welfare recipients,Defund Planned Parenthood,1,-1,3,6,3,1.4970228592367723,1,6,1,0.6549475009160878,3,-1,4,2,0,4,0,4,-4,2,0,3.1645
1,R_1eEotFgXgjm2k7Z,75,f,1,1,2665.1999999284744,Ban on research with animals,Remove police from schools,1,1,2,6,3,1.07598518007643,-3,5,2,-1.029203215725281,2,-3,5,5,1,5,1,5,-5,5,0,2.6651999999284746
1,R_1eEotFgXgjm2k7Z,76,f,1,1,4875,Remove police from schools,Defund the police,1,1,-3,5,2,-1.029203215725281,-3,8,3,-1.029203215725281,-3,-3,0,0,-3,0,3,0,0,0,0,4.875
1,R_1eEotFgXgjm2k7Z,77,f,1,1,6076.800000071526,Remove Christopher Columbus statues,War on Drugs,-1,-1,-3,5,2,-1.029203215725281,3,7,4,1.4970228592367723,3,-3,6,-6,-2,6,2,6,-6,-6,0,6.076800000071525
1,R_1eEotFgXgjm2k7Z,78,j,2,0,3712.600000023842,Black Lives Matter,Remove police from schools,1,-1,-2,7,3,-0.6081655365649388,-3,5,2,-1.029203215725281,-2,3,5,-1,-2,5,2,-5,5,1,1,3.712600000023842
1,R_1eEotFgXgjm2k7Z,79,f,1,1,3917.7999999523163,Black Lives Matter,Lift COVID lockdowns,-1,1,-2,7,3,-0.6081655365649388,3,5,3,1.4970228592367723,2,3,-1,-5,2,1,2,-1,1,-5,0,3.917799999952316
1,R_1eEotFgXgjm2k7Z,80,f,1,1,3953.2999999523163,Lift COVID lockdowns,Physician-assisted suicide,1,1,3,5,3,1.4970228592367723,2,3,3,1.07598518007643,3,2,1,1,2,1,2,1,-1,1,0,3.9532999999523164
1,R_1eEotFgXgjm2k7Z,81,f,1,1,3336.3000000715256,Mandatory training on sexual consent,Remove Christopher Columbus statues,-1,1,0,0,1,0.2339098217557456,-3,5,2,-1.029203215725281,-0,-3,3,3,-5,3,5,3,-3,3,0,3.3363000000715255
1,R_1eEotFgXgjm2k7Z,82,f,1,1,5117.399999976158,Mandatory drug tests for welfare recipients,Mask mandates,-1,1,3,6,3,1.4970228592367723,-3,3,4,-1.029203215725281,-3,-3,0,6,3,0,3,0,0,6,0,5.117399999976159
1,R_1eEotFgXgjm2k7Z,83,j,2,0,3198.5,Increased Gun regulations,Lift COVID lockdowns,1,1,-2,6,3,-0.6081655365649388,3,5,3,1.4970228592367723,-2,3,5,5,-1,5,1,-5,5,-5,1,3.1985
1,R_1eEotFgXgjm2k7Z,84,f,1,1,3052.100000023842,Remove public Confederate memorials,Remove police from schools,-1,1,-3,4,2,-1.029203215725281,-3,5,2,-1.029203215725281,3,-3,6,0,-1,6,1,6,-6,0,0,3.052100000023842
1,R_1eEotFgXgjm2k7Z,85,f,1,1,3540.600000023842,Raise the minimum wage,Remove public Confederate memorials,-1,1,-3,5,4,-1.029203215725281,-3,4,2,-1.029203215725281,3,-3,6,0,1,6,1,6,-6,0,0,3.540600000023842
1,R_1eEotFgXgjm2k7Z,86,j,2,0,2947.9000000953674,Remove public Confederate memorials,Mandatory drug tests for welfare recipients,1,1,-3,4,2,-1.029203215725281,3,6,3,1.4970228592367723,-3,3,6,6,2,6,2,-6,6,-6,1,2.9479000000953675
1,R_1eEotFgXgjm2k7Z,87,f,1,1,3493.2999999523163,Ban on research with animals,Raise the minimum wage,1,-1,2,6,3,1.07598518007643,-3,5,4,-1.029203215725281,2,3,-1,5,1,1,1,-1,1,5,0,3.4932999999523164
1,R_1eEotFgXgjm2k7Z,88,f,1,1,4815.799999952316,Mandatory drug tests for welfare recipients,War on Drugs,1,1,3,6,3,1.4970228592367723,3,7,4,1.4970228592367723,3,3,0,0,-1,0,1,0,0,0,0,4.815799999952317
1,R_1eEotFgXgjm2k7Z,89,j,2,0,3095.1999999284744,War on Drugs,Mandatory drug tests for welfare recipients,-1,-1,3,7,4,1.4970228592367723,3,6,3,1.4970228592367723,-3,-3,0,0,-1,0,1,0,0,0,1,3.0951999999284743
1,R_1eEotFgXgjm2k7Z,90,j,2,0,2599.600000023842,Legalization of marijuana,Abolishing fraternities,1,-1,-3,5,3,-1.029203215725281,-2,2,1,-0.6081655365649388,-3,2,5,1,-3,5,3,-5,5,-1,1,2.599600000023842
1,R_1eEotFgXgjm2k7Z,91,f,1,1,2460,Mandatory drug tests for welfare recipients,Mandatory drug tests for welfare recipients,1,-1,3,6,3,1.4970228592367723,3,6,3,1.4970228592367723,3,-3,6,0,0,6,0,6,-6,0,0,2.46
1,R_1eEotFgXgjm2k7Z,92,j,2,0,3081.7000000476837,Hardening schools/Arming teachers,Remove Christopher Columbus statues,1,-1,1,1,1,0.6549475009160878,-3,5,2,-1.029203215725281,1,3,2,-4,4,2,4,-2,2,4,1,3.0817000000476837
1,R_1eEotFgXgjm2k7Z,93,f,1,1,3592.3000000715256,Mandatory drug tests for welfare recipients,Remove public Confederate memorials,1,-1,3,6,3,1.4970228592367723,-3,4,2,-1.029203215725281,3,3,0,6,2,0,2,0,0,6,0,3.5923000000715257
1,R_1eEotFgXgjm2k7Z,94,f,1,1,6945.299999952316,Abortion rights,Remove police from schools,-1,1,2,1,4,1.07598518007643,-3,5,2,-1.029203215725281,-2,-3,1,5,-4,1,4,1,-1,5,0,6.945299999952316
1,R_1eEotFgXgjm2k7Z,95,f,1,1,6909.5,Remove Christopher Columbus statues,War on Drugs,1,-1,-3,5,2,-1.029203215725281,3,7,4,1.4970228592367723,-3,-3,0,-6,-2,0,2,0,0,-6,0,6.9095
1,R_1eEotFgXgjm2k7Z,96,j,2,0,2983,Mandatory drug tests for welfare recipients,On campus concealed carry,-1,1,3,6,3,1.4970228592367723,2,2,1,1.07598518007643,-3,2,5,-1,-4,5,4,-5,5,1,1,2.983
1,R_1eEotFgXgjm2k7Z,97,j,2,0,4323.099999904633,Defund Planned Parenthood,Remove Christopher Columbus statues,1,-1,1,6,1,0.6549475009160878,-3,5,2,-1.029203215725281,1,3,2,-4,-1,2,1,-2,2,4,1,4.323099999904633
1,R_1eEotFgXgjm2k7Z,98,j,2,0,4591.899999976158,Abortion rights,Lift COVID lockdowns,1,1,2,1,4,1.07598518007643,3,5,3,1.4970228592367723,2,3,1,1,4,1,4,-1,1,-1,1,4.5918999999761585
1,R_1eEotFgXgjm2k7Z,99,f,1,1,2894.5,Mandatory drug tests for welfare recipients,Legalization of marijuana,1,1,3,6,3,1.4970228592367723,-3,5,3,-1.029203215725281,3,-3,6,6,1,6,1,6,-6,6,0,2.8945
1,R_1eEotFgXgjm2k7Z,100,j,2,0,1858.8000000715256,Remove police from schools,War on Drugs,1,1,-3,5,2,-1.029203215725281,3,7,4,1.4970228592367723,-3,3,6,6,2,6,2,-6,6,-6,1,1.8588000000715257
11,R_32SljSkAHRv1s4C,1,f,1,1,2056.800000190735,Bathrooms restricted based on biological sex,Physician-assisted suicide,1,1,2,7,3,0.3486083443891983,2,6,3,0.3486083443891983,2,2,0,0,1,0,1,0,0,0,0,2.056800000190735
11,R_32SljSkAHRv1s4C,3,f,1,1,229,Defund Planned Parenthood,Recognize Jerusalem as capital of Israel,1,-1,3,7,3,1.91734589414059,2,7,2,0.3486083443891983,3,-2,5,1,0,5,0,5,-5,1,0,0.229
11,R_32SljSkAHRv1s4C,4,f,1,1,176.30000019073486,University Campus should be a Sanctuary,On campus concealed carry,1,-1,3,6,3,1.91734589414059,2,3,3,0.3486083443891983,3,-2,5,1,3,5,3,5,-5,1,0,0.17630000019073486
11,R_32SljSkAHRv1s4C,5,f,1,1,721.1999998092651,On campus concealed carry,Mandatory training on sexual consent,-1,-1,2,3,3,0.3486083443891983,3,7,3,1.91734589414059,-2,-3,1,-1,-4,1,4,1,-1,-1,0,0.7211999998092652
11,R_32SljSkAHRv1s4C,6,f,1,1,187.2999997138977,Tuition increases,War on Drugs,1,1,2,8,4,0.3486083443891983,2,6,3,0.3486083443891983,2,2,0,0,2,0,2,0,0,0,0,0.1872999997138977
11,R_32SljSkAHRv1s4C,7,f,1,1,23060.700000286102,Defund Planned Parenthood,Ban on ethnic Halloween costumes,-1,1,3,7,3,1.91734589414059,1,7,3,-1.2201292053621933,-3,1,-4,2,0,4,0,-4,4,2,0,23.0607000002861
11,R_32SljSkAHRv1s4C,8,f,1,1,1605,Recognize Jerusalem as capital of Israel,Expel students with white nationlist views,-1,-1,2,7,2,0.3486083443891983,1,6,4,-1.2201292053621933,-2,-1,-1,1,1,1,1,-1,1,1,0,1.605
11,R_32SljSkAHRv1s4C,9,j,2,0,2465.699999809265,Build southern border wall,Defund Planned Parenthood,-1,-1,1,7,3,-1.2201292053621933,3,7,3,1.91734589414059,-1,-3,-2,2,0,2,0,2,-2,-2,1,2.465699999809265
11,R_32SljSkAHRv1s4C,10,f,1,1,1765,Safe injection locations,On campus concealed carry,1,-1,2,7,3,0.3486083443891983,2,3,3,0.3486083443891983,2,-2,4,0,4,4,4,4,-4,0,0,1.765
11,R_32SljSkAHRv1s4C,11,f,1,1,16197.099999904633,University Campus should be a Sanctuary,Tuition increases,-1,1,3,6,3,1.91734589414059,2,8,4,0.3486083443891983,-3,2,-5,1,-2,5,2,-5,5,1,0,16.197099999904633
11,R_32SljSkAHRv1s4C,12,f,1,1,4580.900000095367,Tuition increases,University Campus should be a Sanctuary,-1,-1,2,8,4,0.3486083443891983,3,6,3,1.91734589414059,-2,-3,1,-1,2,1,2,1,-1,-1,0,4.580900000095367
11,R_32SljSkAHRv1s4C,13,j,2,0,2275.0999999046326,Mandatory training on sexual consent,Defund Planned Parenthood,1,-1,3,7,3,1.91734589414059,3,7,3,1.91734589414059,3,-3,-6,0,0,6,0,6,-6,0,1,2.2750999999046324
11,R_32SljSkAHRv1s4C,14,f,1,1,2056.800000190735,Mandatory training on sexual consent,Abolishing private prisons,-1,1,3,7,3,1.91734589414059,2,6,3,0.3486083443891983,-3,2,-5,1,1,5,1,-5,5,1,0,2.056800000190735
11,R_32SljSkAHRv1s4C,15,j,2,0,4324.900000095367,Mandatory training on sexual consent,Ban on ethnic Halloween costumes,1,-1,3,7,3,1.91734589414059,1,7,3,-1.2201292053621933,3,-1,-4,-2,0,4,0,4,-4,2,1,4.324900000095368
11,R_32SljSkAHRv1s4C,16,j,2,0,5312.300000190735,Stop police brutality,Tuition increases,1,-1,2,7,3,0.3486083443891983,2,8,4,0.3486083443891983,2,-2,-4,0,1,4,1,4,-4,0,1,5.312300000190735
11,R_32SljSkAHRv1s4C,17,f,1,1,4630.5,Tuition increases,On campus concealed carry,-1,1,2,8,4,0.3486083443891983,2,3,3,0.3486083443891983,-2,2,-4,0,5,4,5,-4,4,0,0,4.6305
11,R_32SljSkAHRv1s4C,18,j,2,0,3520.4000000953674,Remove Christopher Columbus statues,Expel students with white nationlist views,-1,1,2,7,3,0.3486083443891983,1,6,4,-1.2201292053621933,-2,1,3,-1,-1,3,1,-3,3,1,1,3.5204000000953672
11,R_32SljSkAHRv1s4C,19,j,2,0,1229,Mask mandates,Gun-free campus police,1,1,1,7,3,-1.2201292053621933,2,7,3,0.3486083443891983,1,2,1,1,0,1,0,-1,1,-1,1,1.229
11,R_32SljSkAHRv1s4C,20,j,2,0,3489.5,Religious exemptions for discrimination laws,War on Drugs,1,1,3,7,2,1.91734589414059,2,6,3,0.3486083443891983,3,2,-1,-1,-1,1,1,1,-1,1,1,3.4895
11,R_32SljSkAHRv1s4C,22,f,1,1,1648.9000000953674,Mandatory vaccinations,Physician-assisted suicide,-1,-1,1,6,3,-1.2201292053621933,2,6,3,0.3486083443891983,-1,-2,1,-1,0,1,0,1,-1,-1,0,1.6489000000953675
11,R_32SljSkAHRv1s4C,23,j,2,0,1809.3000001907349,Mask mandates,Remove public Confederate memorials,1,-1,1,7,3,-1.2201292053621933,2,7,3,0.3486083443891983,1,-2,-3,1,0,3,0,3,-3,-1,1,1.809300000190735
11,R_32SljSkAHRv1s4C,24,f,1,1,2150,War on Drugs,Stop police brutality,-1,-1,2,6,3,0.3486083443891983,2,7,3,0.3486083443891983,-2,-2,0,0,-1,0,1,0,0,0,0,2.15
11,R_32SljSkAHRv1s4C,25,j,2,0,3032.9000000953674,On campus concealed carry,Cuts to National Parks budget,1,-1,2,3,3,0.3486083443891983,2,6,3,0.3486083443891983,2,-2,-4,0,3,4,3,4,-4,0,1,3.0329000000953674
11,R_32SljSkAHRv1s4C,26,f,1,1,31720.900000095367,Defund Planned Parenthood,University Campus should be a Sanctuary,-1,-1,3,7,3,1.91734589414059,3,6,3,1.91734589414059,-3,-3,0,0,1,0,1,0,0,0,0,31.720900000095366
11,R_32SljSkAHRv1s4C,27,j,2,0,1180.6000003814697,War on Drugs,University Campus should be a Sanctuary,-1,-1,2,6,3,0.3486083443891983,3,6,3,1.91734589414059,-2,-3,-1,1,0,1,0,1,-1,-1,1,1.1806000003814696
11,R_32SljSkAHRv1s4C,28,f,1,1,36717.2000002861,Abolishing private prisons,Defund the police,1,1,2,6,3,0.3486083443891983,1,7,3,-1.2201292053621933,2,1,1,1,-1,1,1,1,-1,1,0,36.717200000286105
11,R_32SljSkAHRv1s4C,29,j,2,0,1676.9000000953674,On campus concealed carry,Defund the police,1,-1,2,3,3,0.3486083443891983,1,7,3,-1.2201292053621933,2,-1,-3,-1,4,3,4,3,-3,1,1,1.6769000000953673
11,R_32SljSkAHRv1s4C,30,j,2,0,1670.2000002861023,Mandatory training on sexual consent,Tuition increases,-1,-1,3,7,3,1.91734589414059,2,8,4,0.3486083443891983,-3,-2,1,-1,1,1,1,-1,1,1,1,1.6702000002861024
11,R_32SljSkAHRv1s4C,31,j,2,0,837.1000003814697,University Campus should be a Sanctuary,University Campus should be a Sanctuary,1,-1,3,6,3,1.91734589414059,3,6,3,1.91734589414059,3,-3,-6,0,0,6,0,6,-6,0,1,0.8371000003814697
11,R_32SljSkAHRv1s4C,32,f,1,1,2051.300000190735,Mandatory training on sexual consent,Gun-free campus police,-1,-1,3,7,3,1.91734589414059,2,7,3,0.3486083443891983,-3,-2,-1,1,0,1,0,-1,1,1,0,2.051300000190735
11,R_32SljSkAHRv1s4C,33,f,1,1,16642.800000190735,Religious exemptions for discrimination laws,On campus concealed carry,1,-1,3,7,2,1.91734589414059,2,3,3,0.3486083443891983,3,-2,5,1,4,5,4,5,-5,1,0,16.642800000190736
11,R_32SljSkAHRv1s4C,34,j,2,0,1818.8000001907349,On campus concealed carry,Remove Christopher Columbus statues,1,1,2,3,3,0.3486083443891983,2,7,3,0.3486083443891983,2,2,0,0,4,0,4,0,0,0,1,1.818800000190735
11,R_32SljSkAHRv1s4C,35,f,1,1,1456,University Campus should be a Sanctuary,Remove Christopher Columbus statues,-1,1,3,6,3,1.91734589414059,2,7,3,0.3486083443891983,-3,2,-5,1,-1,5,1,-5,5,1,0,1.456
11,R_32SljSkAHRv1s4C,36,j,2,0,1884.0999999046326,University Campus should be a Sanctuary,Mandatory training on sexual consent,1,1,3,6,3,1.91734589414059,3,7,3,1.91734589414059,3,3,0,0,1,0,1,0,0,0,1,1.8840999999046326
11,R_32SljSkAHRv1s4C,37,f,1,1,1258.3999996185303,Tuition increases,On campus concealed carry,1,1,2,8,4,0.3486083443891983,2,3,3,0.3486083443891983,2,2,0,0,5,0,5,0,0,0,0,1.2583999996185302
11,R_32SljSkAHRv1s4C,38,f,1,1,10111.699999809265,Religious exemptions for discrimination laws,University Campus should be a Sanctuary,1,-1,3,7,2,1.91734589414059,3,6,3,1.91734589414059,3,-3,6,0,1,6,1,6,-6,0,0,10.111699999809264
11,R_32SljSkAHRv1s4C,43,j,2,0,22632.800000190735,Mandatory trigger warnings,Religious exemptions for discrimination laws,-1,1,1,6,3,-1.2201292053621933,3,7,2,1.91734589414059,-1,3,4,2,1,4,1,-4,4,-2,1,22.632800000190734
11,R_32SljSkAHRv1s4C,44,j,2,0,1945.5999999046326,University Campus should be a Sanctuary,Affirmative action,1,-1,3,6,3,1.91734589414059,2,6,3,0.3486083443891983,3,-2,-5,-1,0,5,0,5,-5,1,1,1.9455999999046325
11,R_32SljSkAHRv1s4C,45,f,1,1,2702.5,University Campus should be a Sanctuary,Black Lives Matter,-1,1,3,6,3,1.91734589414059,1,7,3,-1.2201292053621933,-3,1,-4,2,-1,4,1,-4,4,2,0,2.7025
11,R_32SljSkAHRv1s4C,46,j,2,0,1296.4000000953674,Tuition increases,Affirmative action,1,-1,2,8,4,0.3486083443891983,2,6,3,0.3486083443891983,2,-2,-4,0,-2,4,2,4,-4,0,1,1.2964000000953675
11,R_32SljSkAHRv1s4C,47,f,1,1,1553,War on Drugs,Climate change legislation,1,-1,2,6,3,0.3486083443891983,1,7,3,-1.2201292053621933,2,-1,3,1,-1,3,1,3,-3,1,0,1.553
11,R_32SljSkAHRv1s4C,48,j,2,0,318.7999997138977,War on Drugs,On campus concealed carry,1,1,2,6,3,0.3486083443891983,2,3,3,0.3486083443891983,2,2,0,0,-3,0,3,0,0,0,1,0.3187999997138977
11,R_32SljSkAHRv1s4C,49,f,1,1,16931.60000038147,Mask mandates,University Campus should be a Sanctuary,-1,-1,1,7,3,-1.2201292053621933,3,6,3,1.91734589414059,-1,-3,2,-2,1,2,1,2,-2,-2,0,16.93160000038147
11,R_32SljSkAHRv1s4C,50,j,2,0,410.5,On campus concealed carry,Mandatory training on sexual consent,1,1,2,3,3,0.3486083443891983,3,7,3,1.91734589414059,2,3,1,1,4,1,4,-1,1,-1,1,0.4105
11,R_32SljSkAHRv1s4C,51,f,1,1,1553.6999998092651,University Campus should be a Sanctuary,Tuition increases,1,1,3,6,3,1.91734589414059,2,8,4,0.3486083443891983,3,2,1,1,-2,1,2,1,-1,1,0,1.553699999809265
11,R_32SljSkAHRv1s4C,52,f,1,1,1602.0999999046326,University Campus should be a Sanctuary,On campus concealed carry,-1,-1,3,6,3,1.91734589414059,2,3,3,0.3486083443891983,-3,-2,-1,1,3,1,3,-1,1,1,0,1.6020999999046326
11,R_32SljSkAHRv1s4C,53,j,2,0,2260.6000003814697,Religious exemptions for discrimination laws,War on Drugs,-1,-1,3,7,2,1.91734589414059,2,6,3,0.3486083443891983,-3,-2,1,-1,-1,1,1,-1,1,1,1,2.2606000003814697
11,R_32SljSkAHRv1s4C,54,j,2,0,5955.200000286102,Build southern border wall,University Campus should be a Sanctuary,1,1,1,7,3,-1.2201292053621933,3,6,3,1.91734589414059,1,3,2,2,-1,2,1,-2,2,-2,1,5.955200000286102
11,R_32SljSkAHRv1s4C,55,f,1,1,1155.9000000953674,On campus concealed carry,University Campus should be a Sanctuary,1,-1,2,3,3,0.3486083443891983,3,6,3,1.91734589414059,2,-3,5,-1,-3,5,3,5,-5,-1,0,1.1559000000953674
11,R_32SljSkAHRv1s4C,56,f,1,1,659.7999997138977,Gun-free campus police,Defund the police,-1,-1,2,7,3,0.3486083443891983,1,7,3,-1.2201292053621933,-2,-1,-1,1,0,1,0,-1,1,1,0,0.6597999997138977
11,R_32SljSkAHRv1s4C,57,f,1,1,2320,Mandatory training on sexual consent,Student worker unionization,-1,1,3,7,3,1.91734589414059,1,6,2,-1.2201292053621933,-3,1,-4,2,1,4,1,-4,4,2,0,2.32
11,R_32SljSkAHRv1s4C,58,f,1,1,20103.199999809265,U.S. drone strikes in Afghanistan,Abolishing private prisons,1,-1,1,6,2,-1.2201292053621933,2,6,3,0.3486083443891983,1,-2,3,-1,0,3,0,3,-3,-1,0,20.103199999809267
11,R_32SljSkAHRv1s4C,59,j,2,0,1105.2000002861023,Mandatory vaccinations,University Campus should be a Sanctuary,-1,-1,1,6,3,-1.2201292053621933,3,6,3,1.91734589414059,-1,-3,-2,2,0,2,0,2,-2,-2,1,1.1052000002861022
11,R_32SljSkAHRv1s4C,60,j,2,0,1205.6999998092651,Increased Gun regulations,University Campus should be a Sanctuary,1,-1,2,6,3,0.3486083443891983,3,6,3,1.91734589414059,2,-3,-5,1,0,5,0,5,-5,-1,1,1.2056999998092652
11,R_32SljSkAHRv1s4C,61,f,1,1,2267.2999997138977,Increased Gun regulations,Affirmative action,1,-1,2,6,3,0.3486083443891983,2,6,3,0.3486083443891983,2,-2,4,0,0,4,0,4,-4,0,0,2.267299999713898
11,R_32SljSkAHRv1s4C,62,f,1,1,19463.199999809265,Affirmative action,Stop police brutality,-1,1,2,6,3,0.3486083443891983,2,7,3,0.3486083443891983,-2,2,-4,0,-1,4,1,-4,4,0,0,19.463199999809266
11,R_32SljSkAHRv1s4C,63,j,2,0,1670.0999999046326,Physician-assisted suicide,Tuition increases,-1,-1,2,6,3,0.3486083443891983,2,8,4,0.3486083443891983,-2,-2,0,0,2,0,2,0,0,0,1,1.6700999999046326
11,R_32SljSkAHRv1s4C,64,f,1,1,1192.3000001907349,Recognize Jerusalem as capital of Israel,Mandatory trigger warnings,1,1,2,7,2,0.3486083443891983,1,6,3,-1.2201292053621933,2,1,1,1,1,1,1,1,-1,1,0,1.192300000190735
11,R_32SljSkAHRv1s4C,65,f,1,1,1372.5,Defund the police,University Campus should be a Sanctuary,-1,1,1,7,3,-1.2201292053621933,3,6,3,1.91734589414059,-1,3,-4,-2,1,4,1,-4,4,-2,0,1.3725
11,R_32SljSkAHRv1s4C,66,f,1,1,865.5999999046326,Mandatory vaccinations,On campus concealed carry,1,1,1,6,3,-1.2201292053621933,2,3,3,0.3486083443891983,1,2,-1,-1,3,1,3,-1,1,-1,0,0.8655999999046325
11,R_32SljSkAHRv1s4C,67,f,1,1,34452.90000009537,Expel students with white nationlist views,Defund Planned Parenthood,-1,-1,1,6,4,-1.2201292053621933,3,7,3,1.91734589414059,-1,-3,2,-2,-1,2,1,2,-2,-2,0,34.45290000009537
11,R_32SljSkAHRv1s4C,68,f,1,1,2405.5,On campus concealed carry,Ban on ethnic Halloween costumes,1,1,2,3,3,0.3486083443891983,1,7,3,-1.2201292053621933,2,1,1,1,-4,1,4,1,-1,1,0,2.4055
11,R_32SljSkAHRv1s4C,70,f,1,1,392.09999990463257,Mandatory training on sexual consent,Tuition increases,-1,1,3,7,3,1.91734589414059,2,8,4,0.3486083443891983,-3,2,-5,1,-1,5,1,-5,5,1,0,0.39209999990463257
11,R_32SljSkAHRv1s4C,72,f,1,1,5332.700000286102,On campus concealed carry,University Campus should be a Sanctuary,1,1,2,3,3,0.3486083443891983,3,6,3,1.91734589414059,2,3,-1,-1,-3,1,3,-1,1,-1,0,5.332700000286103
11,R_32SljSkAHRv1s4C,73,f,1,1,1485.4000000953674,Tuition increases,University Campus should be a Sanctuary,-1,1,2,8,4,0.3486083443891983,3,6,3,1.91734589414059,-2,3,-5,-1,2,5,2,-5,5,-1,0,1.4854000000953673
11,R_32SljSkAHRv1s4C,74,j,2,0,1449.0999999046326,On campus concealed carry,On campus concealed carry,-1,1,2,3,3,0.3486083443891983,2,3,3,0.3486083443891983,-2,2,4,0,0,4,0,-4,4,0,1,1.4490999999046326
11,R_32SljSkAHRv1s4C,75,f,1,1,1460.2999997138977,Student worker unionization,University Campus should be a Sanctuary,1,1,1,6,2,-1.2201292053621933,3,6,3,1.91734589414059,1,3,-2,-2,0,2,0,-2,2,-2,0,1.4602999997138977
11,R_32SljSkAHRv1s4C,77,j,2,0,8620.099999904633,Allow alt-right speakers on campus,Tuition increases,-1,-1,2,7,3,0.3486083443891983,2,8,4,0.3486083443891983,-2,-2,0,0,1,0,1,0,0,0,1,8.620099999904632
11,R_32SljSkAHRv1s4C,78,j,2,0,4249.599999904633,Safe injection locations,Gun-free campus police,1,-1,2,7,3,0.3486083443891983,2,7,3,0.3486083443891983,2,-2,-4,0,0,4,0,4,-4,0,1,4.249599999904633
11,R_32SljSkAHRv1s4C,79,f,1,1,1455.5,University Campus should be a Sanctuary,Remove Christopher Columbus statues,-1,-1,3,6,3,1.91734589414059,2,7,3,0.3486083443891983,-3,-2,-1,1,-1,1,1,-1,1,1,0,1.4555
11,R_32SljSkAHRv1s4C,80,f,1,1,2378.5,Expel students with white nationlist views,Safe injection locations,-1,1,1,6,4,-1.2201292053621933,2,7,3,0.3486083443891983,-1,2,-3,-1,-1,3,1,-3,3,-1,0,2.3785
11,R_32SljSkAHRv1s4C,81,j,2,0,458.59999990463257,Mandatory drug tests for welfare recipients,Physician-assisted suicide,1,1,1,6,3,-1.2201292053621933,2,6,3,0.3486083443891983,1,2,1,1,0,1,0,-1,1,-1,1,0.45859999990463257
11,R_32SljSkAHRv1s4C,82,f,1,1,2206.4000000953674,Build southern border wall,"Boycott, Divest, and Sanction Israel",1,-1,1,7,3,-1.2201292053621933,2,6,2,0.3486083443891983,1,-2,3,-1,1,3,1,3,-3,-1,0,2.2064000000953676
11,R_32SljSkAHRv1s4C,83,j,2,0,7226.5,On campus concealed carry,Abolishing private prisons,-1,-1,2,3,3,0.3486083443891983,2,6,3,0.3486083443891983,-2,-2,0,0,3,0,3,0,0,0,1,7.2265
11,R_32SljSkAHRv1s4C,84,f,1,1,3084.0999999046326,On campus concealed carry,Remove Christopher Columbus statues,1,-1,2,3,3,0.3486083443891983,2,7,3,0.3486083443891983,2,-2,4,0,-4,4,4,4,-4,0,0,3.0840999999046326
11,R_32SljSkAHRv1s4C,85,j,2,0,1689,Tuition increases,On campus concealed carry,1,-1,2,8,4,0.3486083443891983,2,3,3,0.3486083443891983,2,-2,-4,0,-5,4,5,4,-4,0,1,1.689
11,R_32SljSkAHRv1s4C,86,j,2,0,2841.5999999046326,Religious exemptions for discrimination laws,Bathrooms restricted based on biological sex,-1,1,3,7,2,1.91734589414059,2,7,3,0.3486083443891983,-3,2,5,-1,0,5,0,-5,5,1,1,2.8415999999046324
11,R_32SljSkAHRv1s4C,87,j,2,0,6312.800000190735,Defund Planned Parenthood,Physician-assisted suicide,1,-1,3,7,3,1.91734589414059,2,6,3,0.3486083443891983,3,-2,-5,-1,-1,5,1,5,-5,1,1,6.312800000190735
11,R_32SljSkAHRv1s4C,88,f,1,1,612.3000001907349,University Campus should be a Sanctuary,Religious exemptions for discrimination laws,1,-1,3,6,3,1.91734589414059,3,7,2,1.91734589414059,3,-3,6,0,-1,6,1,6,-6,0,0,0.6123000001907348
11,R_32SljSkAHRv1s4C,89,f,1,1,13587.599999904633,Allow alt-right speakers on campus,Mandatory training on sexual consent,1,1,2,7,3,0.3486083443891983,3,7,3,1.91734589414059,2,3,-1,-1,0,1,0,-1,1,-1,0,13.587599999904633
11,R_32SljSkAHRv1s4C,90,f,1,1,2877.5,Tuition increases,Ban on research with animals,1,1,2,8,4,0.3486083443891983,2,7,3,0.3486083443891983,2,2,0,0,1,0,1,0,0,0,0,2.8775
11,R_32SljSkAHRv1s4C,91,f,1,1,3032.5999999046326,Mandatory drug tests for welfare recipients,On campus concealed carry,-1,1,1,6,3,-1.2201292053621933,2,3,3,0.3486083443891983,-1,2,-3,-1,3,3,3,-3,3,-1,0,3.0325999999046327
11,R_32SljSkAHRv1s4C,92,j,2,0,924.9000000953674,University Campus should be a Sanctuary,Ban on research with animals,1,-1,3,6,3,1.91734589414059,2,7,3,0.3486083443891983,3,-2,-5,-1,1,5,1,5,-5,1,1,0.9249000000953674
11,R_32SljSkAHRv1s4C,93,f,1,1,1493.7999997138977,University Campus should be a Sanctuary,Recognize Jerusalem as capital of Israel,1,1,3,6,3,1.91734589414059,2,7,2,0.3486083443891983,3,2,1,1,-1,1,1,1,-1,1,0,1.4937999997138978
11,R_32SljSkAHRv1s4C,94,f,1,1,6014.099999904633,Mandatory training on sexual consent,On campus concealed carry,-1,1,3,7,3,1.91734589414059,2,3,3,0.3486083443891983,-3,2,-5,1,4,5,4,-5,5,1,0,6.014099999904633
11,R_32SljSkAHRv1s4C,95,f,1,1,13047.799999713898,Tuition increases,Mandatory training on sexual consent,-1,1,2,8,4,0.3486083443891983,3,7,3,1.91734589414059,-2,3,-5,-1,1,5,1,-5,5,-1,0,13.047799999713897
11,R_32SljSkAHRv1s4C,96,f,1,1,4714.599999904633,Cuts to National Parks budget,Expel students with white nationlist views,1,-1,2,6,3,0.3486083443891983,1,6,4,-1.2201292053621933,2,-1,3,1,0,3,0,3,-3,1,0,4.714599999904633
11,R_32SljSkAHRv1s4C,97,j,2,0,634.1000003814697,"Boycott, Divest, and Sanction Israel",University Campus should be a Sanctuary,1,1,2,6,2,0.3486083443891983,3,6,3,1.91734589414059,2,3,1,1,0,1,0,-1,1,-1,1,0.6341000003814697
11,R_32SljSkAHRv1s4C,98,f,1,1,1410.5999999046326,Mandatory drug tests for welfare recipients,University Campus should be a Sanctuary,1,-1,1,6,3,-1.2201292053621933,3,6,3,1.91734589414059,1,-3,4,-2,0,4,0,4,-4,-2,0,1.4105999999046326
11,R_32SljSkAHRv1s4C,99,j,2,0,4156.199999809265,Mandatory vaccinations,University Campus should be a Sanctuary,-1,1,1,6,3,-1.2201292053621933,3,6,3,1.91734589414059,-1,3,4,2,0,4,0,-4,4,-2,1,4.156199999809266
11,R_32SljSkAHRv1s4C,100,j,2,0,1747.0999999046326,Tuition increases,"Boycott, Divest, and Sanction Israel",-1,1,2,8,4,0.3486083443891983,2,6,2,0.3486083443891983,-2,2,4,0,-2,4,2,-4,4,0,1,1.7470999999046326
17,R_vMPW2WP9Kg06LRf,1,j,2,0,5565.100000023842,War on Drugs,Mandatory training on sexual consent,-1,-1,3,5,3,0.970007710120885,3,8,2,0.970007710120885,-3,-3,0,0,3,0,3,0,0,0,1,5.5651000000238415
17,R_vMPW2WP9Kg06LRf,2,f,1,1,4686.5,Increased Gun regulations,War on Drugs,-1,-1,3,8,4,0.970007710120885,3,5,3,0.970007710120885,-3,-3,0,0,3,0,3,0,0,0,0,4.6865
17,R_vMPW2WP9Kg06LRf,3,f,1,1,2413.7999999821186,Abortion rights,Legalization of marijuana,-1,-1,3,8,4,0.970007710120885,3,6,3,0.970007710120885,-3,-3,0,0,2,0,2,0,0,0,0,2.4137999999821185
17,R_vMPW2WP9Kg06LRf,4,j,2,0,2583.7999999821186,War on Drugs,Mandatory vaccinations,-1,1,3,5,3,0.970007710120885,1,6,4,-0.39518832634554535,-3,1,4,-2,1,4,1,-4,4,2,1,2.5837999999821184
17,R_vMPW2WP9Kg06LRf,5,j,2,0,2537.199999988079,War on Drugs,Mask mandates,-1,-1,3,5,3,0.970007710120885,2,8,4,0.28740969188766985,-3,-2,1,-1,3,1,3,-1,1,1,1,2.537199999988079
17,R_vMPW2WP9Kg06LRf,6,j,2,0,2373.5,Legalization of marijuana,Bathrooms restricted based on biological sex,-1,-1,3,6,3,0.970007710120885,0,0,1,-1.0777863445787605,-3,-0,3,-3,-6,3,6,-3,3,3,1,2.3735
17,R_vMPW2WP9Kg06LRf,7,f,1,1,2363.5,Raise the minimum wage,Mask mandates,1,-1,3,6,4,0.970007710120885,2,8,4,0.28740969188766985,3,-2,5,1,-2,5,2,5,-5,1,0,2.3635
17,R_vMPW2WP9Kg06LRf,8,j,2,0,1840.4000000059605,Mandatory vaccinations,Ban on research with animals,-1,1,1,6,4,-0.39518832634554535,3,8,4,0.970007710120885,-1,3,4,2,2,4,2,-4,4,-2,1,1.8404000000059604
17,R_vMPW2WP9Kg06LRf,9,f,1,1,1859.7000000178814,Mask mandates,Increased Gun regulations,1,-1,2,8,4,0.28740969188766985,3,8,4,0.970007710120885,2,-3,5,-1,0,5,0,5,-5,-1,0,1.8597000000178814
17,R_vMPW2WP9Kg06LRf,10,j,2,0,4000.800000011921,Remove public Confederate memorials,War on Drugs,-1,-1,0,0,1,-1.0777863445787605,3,5,3,0.970007710120885,-0,-3,-3,3,5,3,5,3,-3,-3,1,4.000800000011921
17,R_vMPW2WP9Kg06LRf,11,j,2,0,1920.0999999940395,War on Drugs,Mandatory vaccinations,1,1,3,5,3,0.970007710120885,1,6,4,-0.39518832634554535,3,1,-2,-2,1,2,1,2,-2,2,1,1.9200999999940396
17,R_vMPW2WP9Kg06LRf,12,f,1,1,13486.799999982119,Mask mandates,War on Drugs,-1,1,2,8,4,0.28740969188766985,3,5,3,0.970007710120885,-2,3,-5,-1,3,5,3,-5,5,-1,0,13.486799999982118
17,R_vMPW2WP9Kg06LRf,13,f,1,1,2136.0999999940395,Legalization of marijuana,War on Drugs,1,1,3,6,3,0.970007710120885,3,5,3,0.970007710120885,3,3,0,0,1,0,1,0,0,0,0,2.1360999999940393
17,R_vMPW2WP9Kg06LRf,14,j,2,0,4516.699999988079,Mandatory vaccinations,War on Drugs,-1,-1,1,6,4,-0.39518832634554535,3,5,3,0.970007710120885,-1,-3,-2,2,-1,2,1,2,-2,-2,1,4.516699999988079
17,R_vMPW2WP9Kg06LRf,15,j,2,0,1689.2000000178814,Legalization of marijuana,Raise the minimum wage,-1,1,3,6,3,0.970007710120885,3,6,4,0.970007710120885,-3,3,6,0,0,6,0,-6,6,0,1,1.6892000000178813
17,R_vMPW2WP9Kg06LRf,16,f,1,1,2321.100000023842,Mask mandates,War on Drugs,1,1,2,8,4,0.28740969188766985,3,5,3,0.970007710120885,2,3,-1,-1,3,1,3,-1,1,-1,0,2.3211000000238418
17,R_vMPW2WP9Kg06LRf,17,j,2,0,3975.699999988079,War on Drugs,Mask mandates,-1,-1,3,5,3,0.970007710120885,2,8,4,0.28740969188766985,-3,-2,1,-1,3,1,3,-1,1,1,1,3.975699999988079
17,R_vMPW2WP9Kg06LRf,18,f,1,1,1605.699999988079,Mandatory vaccinations,Lift COVID lockdowns,1,-1,1,6,4,-0.39518832634554535,0,0,3,-1.0777863445787605,1,-0,1,1,6,1,6,1,-1,1,0,1.605699999988079
17,R_vMPW2WP9Kg06LRf,19,f,1,1,1381.9000000059605,Raise the minimum wage,Mandatory vaccinations,1,-1,3,6,4,0.970007710120885,1,6,4,-0.39518832634554535,3,-1,4,2,0,4,0,4,-4,2,0,1.3819000000059605
17,R_vMPW2WP9Kg06LRf,20,j,2,0,1882.699999988079,Mask mandates,Mandatory training on sexual consent,-1,1,2,8,4,0.28740969188766985,3,8,2,0.970007710120885,-2,3,5,1,0,5,0,-5,5,-1,1,1.8826999999880791
17,R_vMPW2WP9Kg06LRf,21,j,2,0,2039.5999999940395,Mandatory vaccinations,Increased Gun regulations,-1,-1,1,6,4,-0.39518832634554535,3,8,4,0.970007710120885,-1,-3,-2,2,2,2,2,2,-2,-2,1,2.0395999999940395
17,R_vMPW2WP9Kg06LRf,22,j,2,0,2734.2999999821186,Mandatory vaccinations,War on Drugs,-1,-1,1,6,4,-0.39518832634554535,3,5,3,0.970007710120885,-1,-3,-2,2,-1,2,1,2,-2,-2,1,2.7342999999821185
17,R_vMPW2WP9Kg06LRf,23,j,2,0,2322.300000011921,Mandatory training on sexual consent,Mask mandates,-1,-1,3,8,2,0.970007710120885,2,8,4,0.28740969188766985,-3,-2,1,-1,0,1,0,-1,1,1,1,2.322300000011921
17,R_vMPW2WP9Kg06LRf,24,f,1,1,1211,Mask mandates,Mask mandates,1,-1,2,8,4,0.28740969188766985,2,8,4,0.28740969188766985,2,-2,4,0,0,4,0,4,-4,0,0,1.211
17,R_vMPW2WP9Kg06LRf,25,j,2,0,14011,Legalization of marijuana,War on Drugs,-1,1,3,6,3,0.970007710120885,3,5,3,0.970007710120885,-3,3,6,0,-1,6,1,-6,6,0,1,14.011
17,R_vMPW2WP9Kg06LRf,26,f,1,1,1676.5999999940395,War on Drugs,Abortion rights,-1,1,3,5,3,0.970007710120885,3,8,4,0.970007710120885,-3,3,-6,0,-3,6,3,-6,6,0,0,1.6765999999940395
17,R_vMPW2WP9Kg06LRf,27,j,2,0,1217.800000011921,War on Drugs,Increased Gun regulations,-1,1,3,5,3,0.970007710120885,3,8,4,0.970007710120885,-3,3,6,0,3,6,3,-6,6,0,1,1.217800000011921
17,R_vMPW2WP9Kg06LRf,28,j,2,0,1194.0999999940395,Legalization of marijuana,Mask mandates,-1,-1,3,6,3,0.970007710120885,2,8,4,0.28740969188766985,-3,-2,1,-1,2,1,2,-1,1,1,1,1.1940999999940396
17,R_vMPW2WP9Kg06LRf,29,f,1,1,1995.4000000059605,War on Drugs,Mask mandates,1,-1,3,5,3,0.970007710120885,2,8,4,0.28740969188766985,3,-2,5,1,-3,5,3,5,-5,1,0,1.9954000000059604
17,R_vMPW2WP9Kg06LRf,30,j,2,0,1054.199999988079,Physician-assisted suicide,Mandatory training on sexual consent,-1,1,3,8,2,0.970007710120885,3,8,2,0.970007710120885,-3,3,6,0,0,6,0,-6,6,0,1,1.0541999999880791
17,R_vMPW2WP9Kg06LRf,31,j,2,0,1872.2000000178814,Abortion rights,Ban on research with animals,-1,1,3,8,4,0.970007710120885,3,8,4,0.970007710120885,-3,3,6,0,0,6,0,-6,6,0,1,1.8722000000178813
17,R_vMPW2WP9Kg06LRf,32,j,2,0,9067.199999988079,War on Drugs,Legalization of marijuana,-1,1,3,5,3,0.970007710120885,3,6,3,0.970007710120885,-3,3,6,0,1,6,1,-6,6,0,1,9.067199999988079
17,R_vMPW2WP9Kg06LRf,33,f,1,1,1843.5,Detention of migrant children,Mandatory vaccinations,1,-1,0,0,2,-1.0777863445787605,1,6,4,-0.39518832634554535,0,-1,1,-1,-6,1,6,1,-1,-1,0,1.8435
17,R_vMPW2WP9Kg06LRf,34,f,1,1,1228.5999999940395,War on Drugs,Mandatory training on sexual consent,1,1,3,5,3,0.970007710120885,3,8,2,0.970007710120885,3,3,0,0,-3,0,3,0,0,0,0,1.2285999999940396
17,R_vMPW2WP9Kg06LRf,35,j,2,0,1673.5999999940395,Mandatory vaccinations,Ban on research with animals,-1,1,1,6,4,-0.39518832634554535,3,8,4,0.970007710120885,-1,3,4,2,2,4,2,-4,4,-2,1,1.6735999999940396
17,R_vMPW2WP9Kg06LRf,36,j,2,0,1387.800000011921,Legalization of marijuana,Raise the minimum wage,1,-1,3,6,3,0.970007710120885,3,6,4,0.970007710120885,3,-3,-6,0,0,6,0,6,-6,0,1,1.3878000000119208
17,R_vMPW2WP9Kg06LRf,37,f,1,1,1692.0999999940395,War on Drugs,Raise the minimum wage,-1,-1,3,5,3,0.970007710120885,3,6,4,0.970007710120885,-3,-3,0,0,-1,0,1,0,0,0,0,1.6920999999940396
17,R_vMPW2WP9Kg06LRf,38,j,2,0,1069.7000000178814,Mandatory vaccinations,War on Drugs,-1,1,1,6,4,-0.39518832634554535,3,5,3,0.970007710120885,-1,3,4,2,-1,4,1,-4,4,-2,1,1.0697000000178813
17,R_vMPW2WP9Kg06LRf,39,j,2,0,5054.5,Black Lives Matter,War on Drugs,1,1,0,0,2,-1.0777863445787605,3,5,3,0.970007710120885,0,3,3,3,5,3,5,-3,3,-3,1,5.0545
17,R_vMPW2WP9Kg06LRf,40,j,2,0,1762.2000000178814,Legalization of marijuana,Mandatory training on sexual consent,-1,1,3,6,3,0.970007710120885,3,8,2,0.970007710120885,-3,3,6,0,2,6,2,-6,6,0,1,1.7622000000178815
17,R_vMPW2WP9Kg06LRf,41,f,1,1,1443.2000000178814,Climate change legislation,Detention of migrant children,1,-1,3,8,4,0.970007710120885,0,0,2,-1.0777863445787605,3,-0,3,3,8,3,8,3,-3,3,0,1.4432000000178813
17,R_vMPW2WP9Kg06LRf,42,f,1,1,1022.5999999940395,Mandatory training on sexual consent,Mandatory vaccinations,1,1,3,8,2,0.970007710120885,1,6,4,-0.39518832634554535,3,1,2,2,2,2,2,2,-2,2,0,1.0225999999940396
17,R_vMPW2WP9Kg06LRf,43,f,1,1,8714.5,Legalization of marijuana,Mandatory training on sexual consent,1,-1,3,6,3,0.970007710120885,3,8,2,0.970007710120885,3,-3,6,0,-2,6,2,6,-6,0,0,8.7145
17,R_vMPW2WP9Kg06LRf,44,j,2,0,1250,War on Drugs,Mask mandates,1,1,3,5,3,0.970007710120885,2,8,4,0.28740969188766985,3,2,-1,-1,3,1,3,1,-1,1,1,1.25
17,R_vMPW2WP9Kg06LRf,45,f,1,1,1570.699999988079,Mandatory vaccinations,Ban on research with animals,1,-1,1,6,4,-0.39518832634554535,3,8,4,0.970007710120885,1,-3,4,-2,-2,4,2,4,-4,-2,0,1.570699999988079
17,R_vMPW2WP9Kg06LRf,46,j,2,0,1080.3999999761581,Raise the minimum wage,Mask mandates,-1,-1,3,6,4,0.970007710120885,2,8,4,0.28740969188766985,-3,-2,1,-1,2,1,2,-1,1,1,1,1.0803999999761582
17,R_vMPW2WP9Kg06LRf,47,f,1,1,1314.699999988079,Raise the minimum wage,Mask mandates,1,-1,3,6,4,0.970007710120885,2,8,4,0.28740969188766985,3,-2,5,1,-2,5,2,5,-5,1,0,1.314699999988079
17,R_vMPW2WP9Kg06LRf,48,j,2,0,994.7000000178814,U.S. drone strikes in Afghanistan,Mandatory training on sexual consent,-1,-1,0,0,1,-1.0777863445787605,3,8,2,0.970007710120885,-0,-3,-3,3,8,3,8,3,-3,-3,1,0.9947000000178814
17,R_vMPW2WP9Kg06LRf,49,j,2,0,953,War on Drugs,Climate change legislation,1,1,3,5,3,0.970007710120885,3,8,4,0.970007710120885,3,3,0,0,3,0,3,0,0,0,1,0.953
17,R_vMPW2WP9Kg06LRf,50,f,1,1,8562.40000000596,Mandatory vaccinations,Legalization of marijuana,-1,-1,1,6,4,-0.39518832634554535,3,6,3,0.970007710120885,-1,-3,2,-2,0,2,0,2,-2,-2,0,8.56240000000596
17,R_vMPW2WP9Kg06LRf,51,j,2,0,964.1999999880791,Mandatory vaccinations,War on Drugs,1,1,1,6,4,-0.39518832634554535,3,5,3,0.970007710120885,1,3,2,2,-1,2,1,-2,2,-2,1,0.964199999988079
17,R_vMPW2WP9Kg06LRf,52,f,1,1,647.8000000119209,Lift COVID lockdowns,War on Drugs,-1,1,0,0,3,-1.0777863445787605,3,5,3,0.970007710120885,-0,3,-3,-3,-5,3,5,-3,3,-3,0,0.647800000011921
17,R_vMPW2WP9Kg06LRf,53,j,2,0,937.4000000059605,Mask mandates,Increased Gun regulations,1,-1,2,8,4,0.28740969188766985,3,8,4,0.970007710120885,2,-3,-5,1,0,5,0,5,-5,-1,1,0.9374000000059605
17,R_vMPW2WP9Kg06LRf,54,j,2,0,1495.300000011921,Raise the minimum wage,Climate change legislation,-1,1,3,6,4,0.970007710120885,3,8,4,0.970007710120885,-3,3,6,0,2,6,2,-6,6,0,1,1.495300000011921
17,R_vMPW2WP9Kg06LRf,55,j,2,0,2403.699999988079,Mandatory vaccinations,Abortion rights,-1,-1,1,6,4,-0.39518832634554535,3,8,4,0.970007710120885,-1,-3,-2,2,2,2,2,2,-2,-2,1,2.403699999988079
17,R_vMPW2WP9Kg06LRf,56,f,1,1,695.1999999880791,Mandatory vaccinations,Legalization of marijuana,1,1,1,6,4,-0.39518832634554535,3,6,3,0.970007710120885,1,3,-2,-2,0,2,0,-2,2,-2,0,0.695199999988079
17,R_vMPW2WP9Kg06LRf,57,f,1,1,1655.0999999940395,Legalization of marijuana,War on Drugs,-1,-1,3,6,3,0.970007710120885,3,5,3,0.970007710120885,-3,-3,0,0,1,0,1,0,0,0,0,1.6550999999940395
17,R_vMPW2WP9Kg06LRf,58,f,1,1,1938.5999999940395,War on Drugs,Raise the minimum wage,1,-1,3,5,3,0.970007710120885,3,6,4,0.970007710120885,3,-3,6,0,-1,6,1,6,-6,0,0,1.9385999999940395
17,R_vMPW2WP9Kg06LRf,59,j,2,0,879,Raise the minimum wage,Detention of migrant children,-1,1,3,6,4,0.970007710120885,0,0,2,-1.0777863445787605,-3,0,3,-3,-6,3,6,-3,3,3,1,0.879
17,R_vMPW2WP9Kg06LRf,60,f,1,1,1000.7000000178814,Legalization of marijuana,Abolishing fraternities,1,1,3,6,3,0.970007710120885,0,0,1,-1.0777863445787605,3,0,3,3,6,3,6,3,-3,3,0,1.0007000000178814
17,R_vMPW2WP9Kg06LRf,61,j,2,0,8582,Mandatory vaccinations,Raise the minimum wage,-1,-1,1,6,4,-0.39518832634554535,3,6,4,0.970007710120885,-1,-3,-2,2,0,2,0,2,-2,-2,1,8.582
17,R_vMPW2WP9Kg06LRf,62,j,2,0,1540,War on Drugs,Mandatory vaccinations,-1,1,3,5,3,0.970007710120885,1,6,4,-0.39518832634554535,-3,1,4,-2,1,4,1,-4,4,2,1,1.54
17,R_vMPW2WP9Kg06LRf,63,j,2,0,1416.4000000059605,Black Lives Matter,Ban on research with animals,1,1,0,0,2,-1.0777863445787605,3,8,4,0.970007710120885,0,3,3,3,8,3,8,-3,3,-3,1,1.4164000000059604
17,R_vMPW2WP9Kg06LRf,64,j,2,0,1850.5,Mask mandates,Abortion rights,-1,1,2,8,4,0.28740969188766985,3,8,4,0.970007710120885,-2,3,5,1,0,5,0,-5,5,-1,1,1.8505
17,R_vMPW2WP9Kg06LRf,65,f,1,1,1381,Mandatory vaccinations,Legalization of marijuana,1,-1,1,6,4,-0.39518832634554535,3,6,3,0.970007710120885,1,-3,4,-2,0,4,0,4,-4,-2,0,1.381
17,R_vMPW2WP9Kg06LRf,66,f,1,1,5338.4000000059605,Legalization of marijuana,Mandatory vaccinations,1,1,3,6,3,0.970007710120885,1,6,4,-0.39518832634554535,3,1,2,2,0,2,0,2,-2,2,0,5.338400000005961
17,R_vMPW2WP9Kg06LRf,67,j,2,0,1102.5999999940395,Mask mandates,Bathrooms restricted based on biological sex,-1,1,2,8,4,0.28740969188766985,0,0,1,-1.0777863445787605,-2,0,2,-2,-8,2,8,-2,2,2,1,1.1025999999940395
17,R_vMPW2WP9Kg06LRf,68,f,1,1,1505.0999999940395,War on Drugs,Increased Gun regulations,1,-1,3,5,3,0.970007710120885,3,8,4,0.970007710120885,3,-3,6,0,-3,6,3,6,-6,0,0,1.5050999999940395
17,R_vMPW2WP9Kg06LRf,69,f,1,1,1545.9000000059605,Abolishing fraternities,Mask mandates,1,1,0,0,1,-1.0777863445787605,2,8,4,0.28740969188766985,0,2,-2,-2,-8,2,8,-2,2,-2,0,1.5459000000059604
17,R_vMPW2WP9Kg06LRf,70,j,2,0,1079.7999999821186,Mandatory vaccinations,Mandatory vaccinations,-1,1,1,6,4,-0.39518832634554535,1,6,4,-0.39518832634554535,-1,1,2,0,0,2,0,-2,2,0,1,1.0797999999821186
17,R_vMPW2WP9Kg06LRf,71,j,2,0,703.1999999880791,War on Drugs,Mask mandates,-1,1,3,5,3,0.970007710120885,2,8,4,0.28740969188766985,-3,2,5,-1,3,5,3,-5,5,1,1,0.703199999988079
17,R_vMPW2WP9Kg06LRf,72,f,1,1,1364.0999999940395,Mask mandates,Legalization of marijuana,1,-1,2,8,4,0.28740969188766985,3,6,3,0.970007710120885,2,-3,5,-1,2,5,2,5,-5,-1,0,1.3640999999940395
17,R_vMPW2WP9Kg06LRf,73,j,2,0,2224.699999988079,Increased Gun regulations,Raise the minimum wage,-1,-1,3,8,4,0.970007710120885,3,6,4,0.970007710120885,-3,-3,0,0,-2,0,2,0,0,0,1,2.224699999988079
17,R_vMPW2WP9Kg06LRf,74,j,2,0,597.6999999880791,Legalization of marijuana,Mandatory vaccinations,-1,1,3,6,3,0.970007710120885,1,6,4,-0.39518832634554535,-3,1,4,-2,0,4,0,-4,4,2,1,0.5976999999880791
17,R_vMPW2WP9Kg06LRf,75,j,2,0,972.4000000059605,Physician-assisted suicide,Legalization of marijuana,1,1,3,8,2,0.970007710120885,3,6,3,0.970007710120885,3,3,0,0,-2,0,2,0,0,0,1,0.9724000000059605
17,R_vMPW2WP9Kg06LRf,76,f,1,1,1503.4000000059605,Raise the minimum wage,Remove public Confederate memorials,1,-1,3,6,4,0.970007710120885,0,0,1,-1.0777863445787605,3,-0,3,3,6,3,6,3,-3,3,0,1.5034000000059604
17,R_vMPW2WP9Kg06LRf,77,j,2,0,1155.199999988079,Mandatory vaccinations,Mask mandates,-1,-1,1,6,4,-0.39518832634554535,2,8,4,0.28740969188766985,-1,-2,-1,1,2,1,2,1,-1,-1,1,1.155199999988079
17,R_vMPW2WP9Kg06LRf,78,j,2,0,1120.4000000059605,Legalization of marijuana,Abortion rights,1,-1,3,6,3,0.970007710120885,3,8,4,0.970007710120885,3,-3,-6,0,2,6,2,6,-6,0,1,1.1204000000059604
17,R_vMPW2WP9Kg06LRf,79,j,2,0,948,Mask mandates,Mandatory vaccinations,-1,1,2,8,4,0.28740969188766985,1,6,4,-0.39518832634554535,-2,1,3,-1,-2,3,2,-3,3,1,1,0.948
17,R_vMPW2WP9Kg06LRf,80,f,1,1,872.2999999821186,War on Drugs,Raise the minimum wage,1,1,3,5,3,0.970007710120885,3,6,4,0.970007710120885,3,3,0,0,-1,0,1,0,0,0,0,0.8722999999821186
17,R_vMPW2WP9Kg06LRf,81,f,1,1,1263.9000000059605,Mask mandates,Ban on research with animals,-1,-1,2,8,4,0.28740969188766985,3,8,4,0.970007710120885,-2,-3,1,-1,0,1,0,1,-1,-1,0,1.2639000000059604
17,R_vMPW2WP9Kg06LRf,82,j,2,0,935.2000000178814,Abortion rights,Raise the minimum wage,1,1,3,8,4,0.970007710120885,3,6,4,0.970007710120885,3,3,0,0,-2,0,2,0,0,0,1,0.9352000000178814
17,R_vMPW2WP9Kg06LRf,83,j,2,0,929.7999999821186,War on Drugs,War on Drugs,-1,1,3,5,3,0.970007710120885,3,5,3,0.970007710120885,-3,3,6,0,0,6,0,-6,6,0,1,0.9297999999821186
17,R_vMPW2WP9Kg06LRf,84,j,2,0,709.1000000238419,Mask mandates,Climate change legislation,1,1,2,8,4,0.28740969188766985,3,8,4,0.970007710120885,2,3,1,1,0,1,0,-1,1,-1,1,0.7091000000238419
17,R_vMPW2WP9Kg06LRf,85,j,2,0,846.5,Mask mandates,Increased Gun regulations,1,1,2,8,4,0.28740969188766985,3,8,4,0.970007710120885,2,3,1,1,0,1,0,-1,1,-1,1,0.8465
17,R_vMPW2WP9Kg06LRf,86,f,1,1,1106.800000011921,Mandatory vaccinations,Increased Gun regulations,1,-1,1,6,4,-0.39518832634554535,3,8,4,0.970007710120885,1,-3,4,-2,-2,4,2,4,-4,-2,0,1.106800000011921
17,R_vMPW2WP9Kg06LRf,87,f,1,1,4830.899999976158,Mask mandates,Raise the minimum wage,1,1,2,8,4,0.28740969188766985,3,6,4,0.970007710120885,2,3,-1,-1,2,1,2,-1,1,-1,0,4.830899999976158
17,R_vMPW2WP9Kg06LRf,88,j,2,0,4526.299999982119,War on Drugs,War on Drugs,-1,1,3,5,3,0.970007710120885,3,5,3,0.970007710120885,-3,3,6,0,0,6,0,-6,6,0,1,4.526299999982118
17,R_vMPW2WP9Kg06LRf,89,f,1,1,1712.0999999940395,Mask mandates,Raise the minimum wage,1,1,2,8,4,0.28740969188766985,3,6,4,0.970007710120885,2,3,-1,-1,2,1,2,-1,1,-1,0,1.7120999999940396
17,R_vMPW2WP9Kg06LRf,90,j,2,0,1474.2000000178814,Mandatory vaccinations,Mask mandates,-1,1,1,6,4,-0.39518832634554535,2,8,4,0.28740969188766985,-1,2,3,1,2,3,2,-3,3,-1,1,1.4742000000178814
17,R_vMPW2WP9Kg06LRf,91,f,1,1,1173.4000000059605,Legalization of marijuana,Mandatory vaccinations,1,-1,3,6,3,0.970007710120885,1,6,4,-0.39518832634554535,3,-1,4,2,0,4,0,4,-4,2,0,1.1734000000059606
17,R_vMPW2WP9Kg06LRf,92,j,2,0,1533.5999999940395,Remove public Confederate memorials,War on Drugs,1,-1,0,0,1,-1.0777863445787605,3,5,3,0.970007710120885,0,-3,-3,3,5,3,5,3,-3,-3,1,1.5335999999940395
17,R_vMPW2WP9Kg06LRf,93,j,2,0,1015.8000000119209,Abortion rights,Mandatory vaccinations,1,1,3,8,4,0.970007710120885,1,6,4,-0.39518832634554535,3,1,-2,-2,-2,2,2,2,-2,2,1,1.015800000011921
17,R_vMPW2WP9Kg06LRf,94,f,1,1,1208,War on Drugs,Ban on research with animals,1,-1,3,5,3,0.970007710120885,3,8,4,0.970007710120885,3,-3,6,0,-3,6,3,6,-6,0,0,1.208
17,R_vMPW2WP9Kg06LRf,95,j,2,0,808.4000000059605,Mask mandates,Mandatory vaccinations,1,1,2,8,4,0.28740969188766985,1,6,4,-0.39518832634554535,2,1,-1,-1,-2,1,2,1,-1,1,1,0.8084000000059605
17,R_vMPW2WP9Kg06LRf,96,f,1,1,963.4000000059605,Mask mandates,War on Drugs,1,-1,2,8,4,0.28740969188766985,3,5,3,0.970007710120885,2,-3,5,-1,3,5,3,5,-5,-1,0,0.9634000000059605
17,R_vMPW2WP9Kg06LRf,97,f,1,1,2429.0999999940395,Mask mandates,Legalization of marijuana,1,-1,2,8,4,0.28740969188766985,3,6,3,0.970007710120885,2,-3,5,-1,2,5,2,5,-5,-1,0,2.4290999999940395
17,R_vMPW2WP9Kg06LRf,98,f,1,1,1342.5999999940395,Lift COVID lockdowns,Abortion rights,1,-1,0,0,3,-1.0777863445787605,3,8,4,0.970007710120885,0,-3,3,-3,-8,3,8,3,-3,-3,0,1.3425999999940395
17,R_vMPW2WP9Kg06LRf,99,j,2,0,1054,War on Drugs,Legalization of marijuana,-1,1,3,5,3,0.970007710120885,3,6,3,0.970007710120885,-3,3,6,0,1,6,1,-6,6,0,1,1.054
17,R_vMPW2WP9Kg06LRf,100,f,1,1,1042.9000000059605,War on Drugs,Mandatory vaccinations,1,-1,3,5,3,0.970007710120885,1,6,4,-0.39518832634554535,3,-1,4,2,-1,4,1,4,-4,2,0,1.0429000000059605
12,R_3vFKRCCTpFYXCud,1,j,2,0,8588.199999988079,Student worker unionization,Detention of migrant children,1,-1,2,7,1,0.9426043378729602,-3,8,4,-1.2431448513976722,2,3,1,-5,1,1,1,-1,1,5,1,8.58819999998808
12,R_3vFKRCCTpFYXCud,2,j,2,0,3449.899999976158,Remove public Confederate memorials,Climate change legislation,1,1,1,4,2,0.5054545000188337,3,8,4,1.3797541757270866,1,3,2,2,4,2,4,-2,2,-2,1,3.449899999976158
12,R_3vFKRCCTpFYXCud,3,j,2,0,3553.2999999523163,Abolishing fraternities,Stop police brutality,-1,1,-1,0,1,-0.3688451756894192,3,8,2,1.3797541757270866,1,3,2,4,8,2,8,-2,2,-4,1,3.5532999999523165
12,R_3vFKRCCTpFYXCud,4,f,1,1,4052.100000023842,"Boycott, Divest, and Sanction Israel",Raise the minimum wage,1,-1,-1,4,3,-0.3688451756894192,3,8,4,1.3797541757270866,-1,-3,2,-4,-4,2,4,2,-2,-4,0,4.052100000023842
12,R_3vFKRCCTpFYXCud,5,j,2,0,3773.600000023842,Defund Planned Parenthood,Cuts to National Parks budget,-1,-1,-3,6,3,-1.2431448513976722,-3,5,2,-1.2431448513976722,3,3,0,0,-1,0,1,0,0,0,1,3.773600000023842
12,R_3vFKRCCTpFYXCud,6,j,2,0,8422,Defund Planned Parenthood,Climate change legislation,1,-1,-3,6,3,-1.2431448513976722,3,8,4,1.3797541757270866,-3,-3,0,6,2,0,2,0,0,-6,1,8.422
12,R_3vFKRCCTpFYXCud,7,j,2,0,3077.300000011921,Student worker unionization,Raise the minimum wage,-1,1,2,7,1,0.9426043378729602,3,8,4,1.3797541757270866,-2,3,5,1,1,5,1,-5,5,-1,1,3.077300000011921
12,R_3vFKRCCTpFYXCud,8,f,1,1,4003.599999964237,Mandatory training on sexual consent,Climate change legislation,1,-1,-3,1,2,-1.2431448513976722,3,8,4,1.3797541757270866,-3,-3,0,-6,-7,0,7,0,0,-6,0,4.003599999964237
12,R_3vFKRCCTpFYXCud,9,f,1,1,4921.699999988079,Legalization of marijuana,Remove police from schools,1,1,3,4,3,1.3797541757270866,-2,2,1,-0.8059950135435456,3,-2,5,5,2,5,2,5,-5,5,0,4.921699999988079
12,R_3vFKRCCTpFYXCud,10,j,2,0,3287.699999988079,Black Lives Matter,Physician-assisted suicide,1,1,0,0,3,0.06830466216470726,3,8,4,1.3797541757270866,0,3,3,3,8,3,8,-3,3,-3,1,3.287699999988079
12,R_3vFKRCCTpFYXCud,11,j,2,0,4158.5,Affirmative action,Mandatory drug tests for welfare recipients,-1,-1,-2,4,3,-0.8059950135435456,-3,8,4,-1.2431448513976722,2,3,1,-1,4,1,4,-1,1,1,1,4.1585
12,R_3vFKRCCTpFYXCud,12,j,2,0,4012.599999964237,Build southern border wall,Student worker unionization,1,-1,-3,4,4,-1.2431448513976722,2,7,1,0.9426043378729602,-3,-2,1,5,3,1,3,-1,1,-5,1,4.012599999964237
12,R_3vFKRCCTpFYXCud,13,j,2,0,4355.899999976158,Detention of migrant children,Remove Christopher Columbus statues,1,-1,-3,8,4,-1.2431448513976722,0,0,1,0.06830466216470726,-3,-0,3,3,-8,3,8,-3,3,-3,1,4.355899999976158
12,R_3vFKRCCTpFYXCud,14,j,2,0,2304.100000023842,Legalization of marijuana,Mandatory training on sexual consent,-1,1,3,4,3,1.3797541757270866,-3,1,2,-1.2431448513976722,-3,-3,0,-6,-3,0,3,0,0,6,1,2.304100000023842
12,R_3vFKRCCTpFYXCud,15,j,2,0,2398.300000011921,Mandatory drug tests for welfare recipients,Recognize Jerusalem as capital of Israel,1,1,-3,8,4,-1.2431448513976722,1,2,2,0.5054545000188337,-3,1,4,4,-6,4,6,-4,4,-4,1,2.398300000011921
12,R_3vFKRCCTpFYXCud,16,j,2,0,5701,Cuts to National Parks budget,Physician-assisted suicide,1,-1,-3,5,2,-1.2431448513976722,3,8,4,1.3797541757270866,-3,-3,0,6,3,0,3,0,0,-6,1,5.701
12,R_3vFKRCCTpFYXCud,17,f,1,1,4126.600000023842,Lift COVID lockdowns,Legalization of marijuana,1,-1,-1,4,2,-0.3688451756894192,3,4,3,1.3797541757270866,-1,-3,2,-4,0,2,0,2,-2,-4,0,4.126600000023842
12,R_3vFKRCCTpFYXCud,18,f,1,1,4376.399999976158,Legalization of marijuana,Hardening schools/Arming teachers,1,-1,3,4,3,1.3797541757270866,-2,2,1,-0.8059950135435456,3,2,1,5,2,1,2,1,-1,5,0,4.376399999976158
12,R_3vFKRCCTpFYXCud,19,j,2,0,2095.699999988079,Abolishing fraternities,Legalization of marijuana,-1,1,-1,0,1,-0.3688451756894192,3,4,3,1.3797541757270866,1,3,2,4,4,2,4,-2,2,-4,1,2.095699999988079
12,R_3vFKRCCTpFYXCud,20,j,2,0,2516,Mandatory training on sexual consent,Physician-assisted suicide,1,1,-3,1,2,-1.2431448513976722,3,8,4,1.3797541757270866,-3,3,6,6,7,6,7,-6,6,-6,1,2.516
12,R_3vFKRCCTpFYXCud,21,f,1,1,2188.600000023842,Mandatory drug tests for welfare recipients,Affirmative action,-1,1,-3,8,4,-1.2431448513976722,-2,4,3,-0.8059950135435456,3,-2,5,-1,4,5,4,5,-5,-1,0,2.188600000023842
12,R_3vFKRCCTpFYXCud,22,f,1,1,4192.299999952316,Remove police from schools,Legalization of marijuana,-1,-1,-2,2,1,-0.8059950135435456,3,4,3,1.3797541757270866,2,-3,5,-5,-2,5,2,5,-5,-5,0,4.192299999952317
12,R_3vFKRCCTpFYXCud,23,f,1,1,2678.100000023842,Mandatory vaccinations,Physician-assisted suicide,1,-1,2,3,3,0.9426043378729602,3,8,4,1.3797541757270866,2,-3,5,-1,-5,5,5,5,-5,-1,0,2.678100000023842
12,R_3vFKRCCTpFYXCud,24,f,1,1,4781,Affirmative action,Ban on research with animals,1,-1,-2,4,3,-0.8059950135435456,3,8,3,1.3797541757270866,-2,-3,1,-5,-4,1,4,1,-1,-5,0,4.781
12,R_3vFKRCCTpFYXCud,25,f,1,1,3710.199999988079,Defund Planned Parenthood,Legalization of marijuana,-1,-1,-3,6,3,-1.2431448513976722,3,4,3,1.3797541757270866,3,-3,6,-6,2,6,2,6,-6,-6,0,3.7101999999880793
12,R_3vFKRCCTpFYXCud,26,f,1,1,1980.5,Legalization of marijuana,Mandatory vaccinations,1,-1,3,4,3,1.3797541757270866,2,3,3,0.9426043378729602,3,-2,5,1,1,5,1,5,-5,1,0,1.9805
12,R_3vFKRCCTpFYXCud,27,f,1,1,4333.300000011921,Bathrooms restricted based on biological sex,Physician-assisted suicide,-1,-1,-1,4,2,-0.3688451756894192,3,8,4,1.3797541757270866,1,-3,4,-4,-4,4,4,4,-4,-4,0,4.333300000011921
12,R_3vFKRCCTpFYXCud,28,f,1,1,2112.400000035763,Mandatory vaccinations,Legalization of marijuana,1,-1,2,3,3,0.9426043378729602,3,4,3,1.3797541757270866,2,-3,5,-1,-1,5,1,5,-5,-1,0,2.112400000035763
12,R_3vFKRCCTpFYXCud,29,j,2,0,2897,Climate change legislation,Mandatory training on sexual consent,-1,-1,3,8,4,1.3797541757270866,-3,1,2,-1.2431448513976722,-3,3,6,-6,-7,6,7,-6,6,6,1,2.897
12,R_3vFKRCCTpFYXCud,30,j,2,0,4035.100000023842,Defund Planned Parenthood,Build southern border wall,-1,-1,-3,6,3,-1.2431448513976722,-3,4,4,-1.2431448513976722,3,3,0,0,-2,0,2,0,0,0,1,4.035100000023842
12,R_3vFKRCCTpFYXCud,31,j,2,0,1785.3999999761581,Student worker unionization,Legalization of marijuana,-1,1,2,7,1,0.9426043378729602,3,4,3,1.3797541757270866,-2,3,5,1,-3,5,3,-5,5,-1,1,1.785399999976158
12,R_3vFKRCCTpFYXCud,32,f,1,1,1862.699999988079,Raise the minimum wage,Recognize Jerusalem as capital of Israel,1,1,3,8,4,1.3797541757270866,1,2,2,0.5054545000188337,3,1,2,2,6,2,6,2,-2,2,0,1.8626999999880791
12,R_3vFKRCCTpFYXCud,33,j,2,0,3333.600000023842,Mandatory drug tests for welfare recipients,Abortion rights,1,1,-3,8,4,-1.2431448513976722,3,5,3,1.3797541757270866,-3,3,6,6,-3,6,3,-6,6,-6,1,3.333600000023842
12,R_3vFKRCCTpFYXCud,34,f,1,1,1994.2000000476837,Climate change legislation,Legalization of marijuana,1,-1,3,8,4,1.3797541757270866,3,4,3,1.3797541757270866,3,-3,6,0,4,6,4,6,-6,0,0,1.9942000000476836
12,R_3vFKRCCTpFYXCud,35,j,2,0,1932.6000000238419,U.S. drone strikes in Afghanistan,Legalization of marijuana,1,1,-2,8,4,-0.8059950135435456,3,4,3,1.3797541757270866,-2,3,5,5,-4,5,4,-5,5,-5,1,1.932600000023842
12,R_3vFKRCCTpFYXCud,36,j,2,0,3444.099999964237,Mandatory vaccinations,Mandatory drug tests for welfare recipients,-1,-1,2,3,3,0.9426043378729602,-3,8,4,-1.2431448513976722,-2,3,5,-5,5,5,5,-5,5,5,1,3.444099999964237
12,R_3vFKRCCTpFYXCud,37,j,2,0,2852.300000011921,Mask mandates,Mandatory drug tests for welfare recipients,1,-1,2,2,3,0.9426043378729602,-3,8,4,-1.2431448513976722,2,3,1,-5,6,1,6,-1,1,5,1,2.8523000000119207
12,R_3vFKRCCTpFYXCud,38,f,1,1,1993.1000000238419,Build southern border wall,Legalization of marijuana,-1,-1,-3,4,4,-1.2431448513976722,3,4,3,1.3797541757270866,3,-3,6,-6,0,6,0,6,-6,-6,0,1.993100000023842
12,R_3vFKRCCTpFYXCud,39,j,2,0,3472.599999964237,Defund Planned Parenthood,Legalization of marijuana,1,1,-3,6,3,-1.2431448513976722,3,4,3,1.3797541757270866,-3,3,6,6,-2,6,2,-6,6,-6,1,3.4725999999642374
12,R_3vFKRCCTpFYXCud,40,f,1,1,4328.199999988079,Religious exemptions for discrimination laws,Remove police from schools,-1,1,-3,8,2,-1.2431448513976722,-2,2,1,-0.8059950135435456,3,-2,5,-1,6,5,6,5,-5,-1,0,4.328199999988079
12,R_3vFKRCCTpFYXCud,41,f,1,1,3185.300000011921,Ban on research with animals,Mandatory training on sexual consent,1,-1,3,8,3,1.3797541757270866,-3,1,2,-1.2431448513976722,3,3,0,6,7,0,7,0,0,6,0,3.185300000011921
12,R_3vFKRCCTpFYXCud,42,f,1,1,6483.400000035763,Abortion rights,Build southern border wall,-1,1,3,5,3,1.3797541757270866,-3,4,4,-1.2431448513976722,-3,-3,0,6,1,0,1,0,0,6,0,6.483400000035763
12,R_3vFKRCCTpFYXCud,43,j,2,0,3350.300000011921,Ban on research with animals,Detention of migrant children,-1,-1,3,8,3,1.3797541757270866,-3,8,4,-1.2431448513976722,-3,3,6,-6,0,6,0,-6,6,6,1,3.350300000011921
12,R_3vFKRCCTpFYXCud,44,j,2,0,2922.800000011921,Lift COVID lockdowns,Ban on research with animals,1,1,-1,4,2,-0.3688451756894192,3,8,3,1.3797541757270866,-1,3,4,4,4,4,4,-4,4,-4,1,2.9228000000119208
12,R_3vFKRCCTpFYXCud,45,j,2,0,2182.199999988079,Mandatory drug tests for welfare recipients,Legalization of marijuana,1,1,-3,8,4,-1.2431448513976722,3,4,3,1.3797541757270866,-3,3,6,6,-4,6,4,-6,6,-6,1,2.1821999999880792
12,R_3vFKRCCTpFYXCud,46,j,2,0,2144.100000023842,Mandatory drug tests for welfare recipients,Abolishing fraternities,1,1,-3,8,4,-1.2431448513976722,-1,0,1,-0.3688451756894192,-3,-1,2,2,-8,2,8,-2,2,-2,1,2.1441000000238417
12,R_3vFKRCCTpFYXCud,47,f,1,1,6824.399999976158,Legalization of marijuana,Defund Planned Parenthood,-1,1,3,4,3,1.3797541757270866,-3,6,3,-1.2431448513976722,-3,-3,0,6,-2,0,2,0,0,6,0,6.824399999976158
12,R_3vFKRCCTpFYXCud,48,j,2,0,6336,Stop police brutality,Abortion rights,1,1,3,8,2,1.3797541757270866,3,5,3,1.3797541757270866,3,3,0,0,-3,0,3,0,0,0,1,6.336
12,R_3vFKRCCTpFYXCud,49,j,2,0,2188.5,Mandatory training on sexual consent,Build southern border wall,1,-1,-3,1,2,-1.2431448513976722,-3,4,4,-1.2431448513976722,-3,3,6,0,3,6,3,-6,6,0,1,2.1885
12,R_3vFKRCCTpFYXCud,50,f,1,1,3269.800000011921,Build southern border wall,Mandatory vaccinations,-1,1,-3,4,4,-1.2431448513976722,2,3,3,0.9426043378729602,3,2,1,-5,1,1,1,1,-1,-5,0,3.2698000000119207
12,R_3vFKRCCTpFYXCud,51,j,2,0,4384,Student worker unionization,Build southern border wall,1,-1,2,7,1,0.9426043378729602,-3,4,4,-1.2431448513976722,2,3,1,-5,-3,1,3,-1,1,5,1,4.384
12,R_3vFKRCCTpFYXCud,52,f,1,1,2820.5,Affirmative action,Physician-assisted suicide,-1,-1,-2,4,3,-0.8059950135435456,3,8,4,1.3797541757270866,2,-3,5,-5,-4,5,4,5,-5,-5,0,2.8205
12,R_3vFKRCCTpFYXCud,53,j,2,0,4112.699999988079,Build southern border wall,Defund the police,1,-1,-3,4,4,-1.2431448513976722,-1,2,2,-0.3688451756894192,-3,1,4,2,-2,4,2,-4,4,-2,1,4.112699999988079
12,R_3vFKRCCTpFYXCud,54,j,2,0,2020.6000000238419,Legalization of marijuana,Remove Christopher Columbus statues,-1,1,3,4,3,1.3797541757270866,0,0,1,0.06830466216470726,-3,0,3,-3,-4,3,4,-3,3,3,1,2.0206000000238418
12,R_3vFKRCCTpFYXCud,55,f,1,1,1879.1000000238419,Legalization of marijuana,Mandatory training on sexual consent,1,-1,3,4,3,1.3797541757270866,-3,1,2,-1.2431448513976722,3,3,0,6,3,0,3,0,0,6,0,1.8791000000238418
12,R_3vFKRCCTpFYXCud,56,f,1,1,2873.300000011921,Physician-assisted suicide,U.S. drone strikes in Afghanistan,-1,1,3,8,4,1.3797541757270866,-2,8,4,-0.8059950135435456,-3,-2,-1,5,0,1,0,-1,1,5,0,2.873300000011921
12,R_3vFKRCCTpFYXCud,57,j,2,0,2386.599999964237,Build southern border wall,U.S. drone strikes in Afghanistan,1,-1,-3,4,4,-1.2431448513976722,-2,8,4,-0.8059950135435456,-3,2,5,1,4,5,4,-5,5,-1,1,2.386599999964237
12,R_3vFKRCCTpFYXCud,58,j,2,0,2748.399999976158,Abortion rights,Cuts to National Parks budget,-1,-1,3,5,3,1.3797541757270866,-3,5,2,-1.2431448513976722,-3,3,6,-6,0,6,0,-6,6,6,1,2.7483999999761584
12,R_3vFKRCCTpFYXCud,59,f,1,1,5294.899999976158,Mandatory vaccinations,Stop police brutality,-1,-1,2,3,3,0.9426043378729602,3,8,2,1.3797541757270866,-2,-3,1,-1,-5,1,5,1,-1,-1,0,5.294899999976158
12,R_3vFKRCCTpFYXCud,60,f,1,1,1654.199999988079,Legalization of marijuana,Abolishing fraternities,1,1,3,4,3,1.3797541757270866,-1,0,1,-0.3688451756894192,3,-1,4,4,4,4,4,4,-4,4,0,1.654199999988079
12,R_3vFKRCCTpFYXCud,61,j,2,0,2854.699999988079,Detention of migrant children,Remove police from schools,1,-1,-3,8,4,-1.2431448513976722,-2,2,1,-0.8059950135435456,-3,2,5,1,-6,5,6,-5,5,-1,1,2.854699999988079
12,R_3vFKRCCTpFYXCud,62,j,2,0,2013,Build southern border wall,Remove police from schools,1,1,-3,4,4,-1.2431448513976722,-2,2,1,-0.8059950135435456,-3,-2,1,1,-2,1,2,-1,1,-1,1,2.013
12,R_3vFKRCCTpFYXCud,63,f,1,1,1571.8999999761581,Legalization of marijuana,Defund the police,1,1,3,4,3,1.3797541757270866,-1,2,2,-0.3688451756894192,3,-1,4,4,2,4,2,4,-4,4,0,1.571899999976158
12,R_3vFKRCCTpFYXCud,64,f,1,1,2220.5,Cuts to National Parks budget,Legalization of marijuana,-1,-1,-3,5,2,-1.2431448513976722,3,4,3,1.3797541757270866,3,-3,6,-6,1,6,1,6,-6,-6,0,2.2205
12,R_3vFKRCCTpFYXCud,65,j,2,0,2340.2999999523163,Legalization of marijuana,Affirmative action,-1,-1,3,4,3,1.3797541757270866,-2,4,3,-0.8059950135435456,-3,2,5,-5,0,5,0,-5,5,5,1,2.3402999999523164
12,R_3vFKRCCTpFYXCud,66,f,1,1,1855.9000000357628,Legalization of marijuana,Remove public Confederate memorials,1,1,3,4,3,1.3797541757270866,1,4,2,0.5054545000188337,3,1,2,2,0,2,0,2,-2,2,0,1.8559000000357628
12,R_3vFKRCCTpFYXCud,67,f,1,1,2350.399999976158,Student worker unionization,Climate change legislation,-1,-1,2,7,1,0.9426043378729602,3,8,4,1.3797541757270866,-2,-3,1,-1,-1,1,1,1,-1,-1,0,2.3503999999761582
12,R_3vFKRCCTpFYXCud,68,j,2,0,5943.300000011921,Build southern border wall,Climate change legislation,-1,1,-3,4,4,-1.2431448513976722,3,8,4,1.3797541757270866,3,3,0,6,4,0,4,0,0,-6,1,5.943300000011921
12,R_3vFKRCCTpFYXCud,69,j,2,0,2086.800000011921,Recognize Jerusalem as capital of Israel,Build southern border wall,1,-1,1,2,2,0.5054545000188337,-3,4,4,-1.2431448513976722,1,3,2,-4,2,2,2,-2,2,4,1,2.086800000011921
12,R_3vFKRCCTpFYXCud,70,j,2,0,2869.099999964237,Cuts to National Parks budget,Detention of migrant children,1,-1,-3,5,2,-1.2431448513976722,-3,8,4,-1.2431448513976722,-3,3,6,0,3,6,3,-6,6,0,1,2.869099999964237
12,R_3vFKRCCTpFYXCud,71,f,1,1,1686,Build southern border wall,Remove public Confederate memorials,-1,-1,-3,4,4,-1.2431448513976722,1,4,2,0.5054545000188337,3,-1,4,-4,0,4,0,4,-4,-4,0,1.686
12,R_3vFKRCCTpFYXCud,72,f,1,1,3144.399999976158,Abolishing fraternities,Build southern border wall,-1,1,-1,0,1,-0.3688451756894192,-3,4,4,-1.2431448513976722,1,-3,4,2,-4,4,4,4,-4,2,0,3.1443999999761583
12,R_3vFKRCCTpFYXCud,73,f,1,1,4132.199999988079,Bathrooms restricted based on biological sex,Build southern border wall,-1,1,-1,4,2,-0.3688451756894192,-3,4,4,-1.2431448513976722,1,-3,4,2,0,4,0,4,-4,2,0,4.132199999988079
12,R_3vFKRCCTpFYXCud,74,f,1,1,1712.199999988079,Mandatory training on sexual consent,Legalization of marijuana,-1,-1,-3,1,2,-1.2431448513976722,3,4,3,1.3797541757270866,3,-3,6,-6,-3,6,3,6,-6,-6,0,1.712199999988079
12,R_3vFKRCCTpFYXCud,75,f,1,1,5098.399999976158,Religious exemptions for discrimination laws,Defund Planned Parenthood,-1,-1,-3,8,2,-1.2431448513976722,-3,6,3,-1.2431448513976722,3,3,0,0,2,0,2,0,0,0,0,5.0983999999761584
12,R_3vFKRCCTpFYXCud,76,j,2,0,2209,Defund the police,Raise the minimum wage,1,1,-1,2,2,-0.3688451756894192,3,8,4,1.3797541757270866,-1,3,4,4,6,4,6,-4,4,-4,1,2.209
12,R_3vFKRCCTpFYXCud,77,f,1,1,2960.5,On campus concealed carry,Build southern border wall,1,1,-1,0,1,-0.3688451756894192,-3,4,4,-1.2431448513976722,-1,-3,2,2,-4,2,4,2,-2,2,0,2.9605
12,R_3vFKRCCTpFYXCud,78,f,1,1,1612.300000011921,Legalization of marijuana,Remove Christopher Columbus statues,1,1,3,4,3,1.3797541757270866,0,0,1,0.06830466216470726,3,0,3,3,4,3,4,3,-3,3,0,1.612300000011921
12,R_3vFKRCCTpFYXCud,79,f,1,1,3177.699999988079,Build southern border wall,Abortion rights,-1,1,-3,4,4,-1.2431448513976722,3,5,3,1.3797541757270866,3,3,0,-6,-1,0,1,0,0,-6,0,3.177699999988079
12,R_3vFKRCCTpFYXCud,80,f,1,1,1773.800000011921,Build southern border wall,Affirmative action,-1,-1,-3,4,4,-1.2431448513976722,-2,4,3,-0.8059950135435456,3,2,1,-1,0,1,0,1,-1,-1,0,1.773800000011921
12,R_3vFKRCCTpFYXCud,81,f,1,1,2674.199999988079,Mandatory drug tests for welfare recipients,Mandatory vaccinations,-1,1,-3,8,4,-1.2431448513976722,2,3,3,0.9426043378729602,3,2,1,-5,5,1,5,1,-1,-5,0,2.6741999999880792
12,R_3vFKRCCTpFYXCud,82,j,2,0,2473.699999988079,Raise the minimum wage,U.S. drone strikes in Afghanistan,-1,-1,3,8,4,1.3797541757270866,-2,8,4,-0.8059950135435456,-3,2,5,-5,0,5,0,-5,5,5,1,2.473699999988079
12,R_3vFKRCCTpFYXCud,83,j,2,0,3010.5,Defund Planned Parenthood,Mandatory drug tests for welfare recipients,1,-1,-3,6,3,-1.2431448513976722,-3,8,4,-1.2431448513976722,-3,3,6,0,2,6,2,-6,6,0,1,3.0105
12,R_3vFKRCCTpFYXCud,84,f,1,1,2668.7000000476837,Physician-assisted suicide,Legalization of marijuana,-1,-1,3,8,4,1.3797541757270866,3,4,3,1.3797541757270866,-3,-3,0,0,4,0,4,0,0,0,0,2.668700000047684
12,R_3vFKRCCTpFYXCud,85,f,1,1,2447.399999976158,Legalization of marijuana,U.S. drone strikes in Afghanistan,-1,1,3,4,3,1.3797541757270866,-2,8,4,-0.8059950135435456,-3,-2,-1,5,-4,1,4,-1,1,5,0,2.447399999976158
12,R_3vFKRCCTpFYXCud,86,f,1,1,4580.700000047684,Abolishing fraternities,Stop police brutality,-1,-1,-1,0,1,-0.3688451756894192,3,8,2,1.3797541757270866,1,-3,4,-4,-8,4,8,4,-4,-4,0,4.580700000047684
12,R_3vFKRCCTpFYXCud,87,j,2,0,1871.0999999642372,Legalization of marijuana,Affirmative action,-1,1,3,4,3,1.3797541757270866,-2,4,3,-0.8059950135435456,-3,-2,1,-5,0,1,0,-1,1,5,1,1.8710999999642373
12,R_3vFKRCCTpFYXCud,88,f,1,1,2265.199999988079,Physician-assisted suicide,U.S. drone strikes in Afghanistan,1,1,3,8,4,1.3797541757270866,-2,8,4,-0.8059950135435456,3,-2,5,5,0,5,0,5,-5,5,0,2.265199999988079
12,R_3vFKRCCTpFYXCud,89,f,1,1,1812.1000000238419,Build southern border wall,Affirmative action,-1,1,-3,4,4,-1.2431448513976722,-2,4,3,-0.8059950135435456,3,-2,5,-1,0,5,0,5,-5,-1,0,1.8121000000238419
12,R_3vFKRCCTpFYXCud,90,j,2,0,3048.599999964237,Legalization of marijuana,Mandatory vaccinations,-1,-1,3,4,3,1.3797541757270866,2,3,3,0.9426043378729602,-3,-2,1,-1,-1,1,1,-1,1,1,1,3.048599999964237
12,R_3vFKRCCTpFYXCud,91,j,2,0,3827.199999988079,Ban on research with animals,Hardening schools/Arming teachers,-1,1,3,8,3,1.3797541757270866,-2,2,1,-0.8059950135435456,-3,-2,1,-5,-6,1,6,-1,1,5,1,3.8271999999880792
12,R_3vFKRCCTpFYXCud,92,j,2,0,2365.599999964237,Cuts to National Parks budget,Build southern border wall,1,-1,-3,5,2,-1.2431448513976722,-3,4,4,-1.2431448513976722,-3,3,6,0,-1,6,1,-6,6,0,1,2.365599999964237
12,R_3vFKRCCTpFYXCud,93,f,1,1,2863.800000011921,Defund Planned Parenthood,Mandatory drug tests for welfare recipients,-1,1,-3,6,3,-1.2431448513976722,-3,8,4,-1.2431448513976722,3,-3,6,0,-2,6,2,6,-6,0,0,2.863800000011921
12,R_3vFKRCCTpFYXCud,94,j,2,0,1994.1000000238419,On campus concealed carry,Religious exemptions for discrimination laws,1,-1,-1,0,1,-0.3688451756894192,-3,8,2,-1.2431448513976722,-1,3,4,-2,8,4,8,-4,4,2,1,1.9941000000238418
12,R_3vFKRCCTpFYXCud,95,f,1,1,2482.399999976158,Student worker unionization,Build southern border wall,1,1,2,7,1,0.9426043378729602,-3,4,4,-1.2431448513976722,2,-3,5,5,3,5,3,5,-5,5,0,2.4823999999761583
12,R_3vFKRCCTpFYXCud,96,f,1,1,3510.600000023842,Defund the police,Stop police brutality,1,-1,-1,2,2,-0.3688451756894192,3,8,2,1.3797541757270866,-1,-3,2,-4,-6,2,6,2,-2,-4,0,3.510600000023842
12,R_3vFKRCCTpFYXCud,97,f,1,1,2289.399999976158,Defund the police,Build southern border wall,1,1,-1,2,2,-0.3688451756894192,-3,4,4,-1.2431448513976722,-1,-3,2,2,-2,2,2,2,-2,2,0,2.2893999999761583
12,R_3vFKRCCTpFYXCud,98,f,1,1,2734.599999964237,U.S. drone strikes in Afghanistan,Religious exemptions for discrimination laws,-1,-1,-2,8,4,-0.8059950135435456,-3,8,2,-1.2431448513976722,2,3,-1,1,0,1,0,-1,1,1,0,2.7345999999642374
12,R_3vFKRCCTpFYXCud,99,f,1,1,2556.600000023842,Student worker unionization,Mandatory drug tests for welfare recipients,1,1,2,7,1,0.9426043378729602,-3,8,4,-1.2431448513976722,2,-3,5,5,-1,5,1,5,-5,5,0,2.556600000023842
12,R_3vFKRCCTpFYXCud,100,j,2,0,4510.600000023842,Build southern border wall,U.S. drone strikes in Afghanistan,-1,-1,-3,4,4,-1.2431448513976722,-2,8,4,-0.8059950135435456,3,2,-1,1,4,1,4,1,-1,-1,1,4.5106000000238415
9,R_2wvLMxIloZ7ffa5,1,f,1,1,1368.4000000059605,Detention of migrant children,Mandatory trigger warnings,1,1,0,5,3,-1.1511666190908498,2,5,4,0.2778678046081365,0,2,-2,-2,0,2,0,-2,2,-2,0,1.3684000000059604
9,R_2wvLMxIloZ7ffa5,2,j,2,0,930.8000000119209,Mandatory trigger warnings,Tuition increases,1,-1,2,5,4,0.2778678046081365,1,7,4,-0.43664940724135665,2,-1,-3,-1,2,3,2,3,-3,1,1,0.930800000011921
9,R_2wvLMxIloZ7ffa5,3,f,1,1,956.7000000178814,Mandatory trigger warnings,Increased Gun regulations,1,1,2,5,4,0.2778678046081365,3,6,3,0.9923850164576297,2,3,-1,-1,-1,1,1,-1,1,-1,0,0.9567000000178814
9,R_2wvLMxIloZ7ffa5,4,f,1,1,2501.5999999940395,Increased Gun regulations,Abortion rights,-1,1,3,6,3,0.9923850164576297,3,5,3,0.9923850164576297,-3,3,-6,0,1,6,1,-6,6,0,0,2.5015999999940397
9,R_2wvLMxIloZ7ffa5,5,j,2,0,1982.5,Ban on ethnic Halloween costumes,Detention of migrant children,-1,-1,1,7,2,-0.43664940724135665,0,5,3,-1.1511666190908498,-1,-0,1,-1,-2,1,2,-1,1,1,1,1.9825
9,R_2wvLMxIloZ7ffa5,6,f,1,1,599.2999999821186,Climate change legislation,Mandatory trigger warnings,1,1,3,5,3,0.9923850164576297,2,5,4,0.2778678046081365,3,2,1,1,0,1,0,1,-1,1,0,0.5992999999821186
9,R_2wvLMxIloZ7ffa5,7,f,1,1,1711.699999988079,Black Lives Matter,War on Drugs,1,-1,1,7,4,-0.43664940724135665,3,5,3,0.9923850164576297,1,-3,4,-2,2,4,2,4,-4,-2,0,1.711699999988079
9,R_2wvLMxIloZ7ffa5,8,j,2,0,2895.2999999821186,Detention of migrant children,Mandatory trigger warnings,-1,1,0,5,3,-1.1511666190908498,2,5,4,0.2778678046081365,-0,2,2,2,0,2,0,-2,2,-2,1,2.8952999999821185
9,R_2wvLMxIloZ7ffa5,9,f,1,1,1000.3000000119209,Increased Gun regulations,Abortion rights,1,-1,3,6,3,0.9923850164576297,3,5,3,0.9923850164576297,3,-3,6,0,1,6,1,6,-6,0,0,1.0003000000119209
9,R_2wvLMxIloZ7ffa5,10,f,1,1,1308,Increased Gun regulations,Increased Gun regulations,1,-1,3,6,3,0.9923850164576297,3,6,3,0.9923850164576297,3,-3,6,0,0,6,0,6,-6,0,0,1.308
9,R_2wvLMxIloZ7ffa5,11,f,1,1,1178.5,Stop police brutality,Tuition increases,1,-1,3,5,3,0.9923850164576297,1,7,4,-0.43664940724135665,3,-1,4,2,-2,4,2,4,-4,2,0,1.1785
9,R_2wvLMxIloZ7ffa5,12,f,1,1,1072.699999988079,Increased Gun regulations,Mandatory trigger warnings,-1,1,3,6,3,0.9923850164576297,2,5,4,0.2778678046081365,-3,2,-5,1,1,5,1,-5,5,1,0,1.072699999988079
9,R_2wvLMxIloZ7ffa5,13,j,2,0,968.5999999940395,Hardening schools/Arming teachers,Increased Gun regulations,1,-1,3,5,3,0.9923850164576297,3,6,3,0.9923850164576297,3,-3,-6,0,1,6,1,6,-6,0,1,0.9685999999940396
9,R_2wvLMxIloZ7ffa5,14,f,1,1,1121.5,Increased Gun regulations,Black Lives Matter,1,-1,3,6,3,0.9923850164576297,1,7,4,-0.43664940724135665,3,-1,4,2,-1,4,1,4,-4,2,0,1.1215
9,R_2wvLMxIloZ7ffa5,15,f,1,1,1473.699999988079,Black Lives Matter,Tuition increases,-1,1,1,7,4,-0.43664940724135665,1,7,4,-0.43664940724135665,-1,1,-2,0,0,2,0,-2,2,0,0,1.473699999988079
9,R_2wvLMxIloZ7ffa5,16,f,1,1,154.19999998807907,Climate change legislation,Cuts to National Parks budget,1,1,3,5,3,0.9923850164576297,1,7,4,-0.43664940724135665,3,1,2,2,-2,2,2,2,-2,2,0,0.15419999998807907
9,R_2wvLMxIloZ7ffa5,17,j,2,0,1376.2999999821186,Mandatory trigger warnings,Ban on ethnic Halloween costumes,-1,-1,2,5,4,0.2778678046081365,1,7,2,-0.43664940724135665,-2,-1,1,-1,2,1,2,-1,1,1,1,1.3762999999821186
9,R_2wvLMxIloZ7ffa5,18,j,2,0,1432.300000011921,Detention of migrant children,Mandatory drug tests for welfare recipients,-1,1,0,5,3,-1.1511666190908498,3,5,3,0.9923850164576297,-0,3,3,3,0,3,0,-3,3,-3,1,1.432300000011921
9,R_2wvLMxIloZ7ffa5,19,j,2,0,914.3000000119209,Defund the police,Mandatory trigger warnings,-1,1,0,7,3,-1.1511666190908498,2,5,4,0.2778678046081365,-0,2,2,2,-2,2,2,-2,2,-2,1,0.9143000000119209
9,R_2wvLMxIloZ7ffa5,20,f,1,1,628.7000000178814,Detention of migrant children,Increased Gun regulations,1,-1,0,5,3,-1.1511666190908498,3,6,3,0.9923850164576297,0,-3,3,-3,-1,3,1,3,-3,-3,0,0.6287000000178814
9,R_2wvLMxIloZ7ffa5,21,j,2,0,1127.7999999821186,Increased Gun regulations,Black Lives Matter,1,-1,3,6,3,0.9923850164576297,1,7,4,-0.43664940724135665,3,-1,-4,-2,1,4,1,4,-4,2,1,1.1277999999821187
9,R_2wvLMxIloZ7ffa5,22,f,1,1,993.4000000059605,Detention of migrant children,Increased Gun regulations,1,1,0,5,3,-1.1511666190908498,3,6,3,0.9923850164576297,0,3,-3,-3,-1,3,1,-3,3,-3,0,0.9934000000059605
9,R_2wvLMxIloZ7ffa5,23,f,1,1,619.7999999821186,Mandatory trigger warnings,Increased Gun regulations,-1,-1,2,5,4,0.2778678046081365,3,6,3,0.9923850164576297,-2,-3,1,-1,-1,1,1,1,-1,-1,0,0.6197999999821187
9,R_2wvLMxIloZ7ffa5,24,j,2,0,726,Increased Gun regulations,Mandatory trigger warnings,-1,-1,3,6,3,0.9923850164576297,2,5,4,0.2778678046081365,-3,-2,1,-1,-1,1,1,-1,1,1,1,0.726
9,R_2wvLMxIloZ7ffa5,25,f,1,1,1129.2000000178814,Ban on research with animals,Mandatory trigger warnings,1,-1,3,5,3,0.9923850164576297,2,5,4,0.2778678046081365,3,-2,5,1,0,5,0,5,-5,1,0,1.1292000000178815
9,R_2wvLMxIloZ7ffa5,26,f,1,1,5191.699999988079,Allow alt-right speakers on campus,Detention of migrant children,1,-1,3,5,3,0.9923850164576297,0,5,3,-1.1511666190908498,3,-0,3,3,0,3,0,3,-3,3,0,5.191699999988079
9,R_2wvLMxIloZ7ffa5,27,j,2,0,3122.7000000178814,Increased Gun regulations,Mandatory drug tests for welfare recipients,1,-1,3,6,3,0.9923850164576297,3,5,3,0.9923850164576297,3,-3,-6,0,-1,6,1,6,-6,0,1,3.1227000000178813
9,R_2wvLMxIloZ7ffa5,28,f,1,1,1493.699999988079,Legalization of marijuana,Cuts to National Parks budget,1,-1,3,5,3,0.9923850164576297,1,7,4,-0.43664940724135665,3,-1,4,2,-2,4,2,4,-4,2,0,1.4936999999880791
9,R_2wvLMxIloZ7ffa5,29,f,1,1,1127,Ban on ethnic Halloween costumes,Mandatory trigger warnings,1,-1,1,7,2,-0.43664940724135665,2,5,4,0.2778678046081365,1,-2,3,-1,2,3,2,3,-3,-1,0,1.127
9,R_2wvLMxIloZ7ffa5,31,j,2,0,1539.9000000059605,Increased Gun regulations,Ban on ethnic Halloween costumes,-1,-1,3,6,3,0.9923850164576297,1,7,2,-0.43664940724135665,-3,-1,2,-2,1,2,1,-2,2,2,1,1.5399000000059604
9,R_2wvLMxIloZ7ffa5,33,f,1,1,841.2000000178814,Increased Gun regulations,Black Lives Matter,-1,1,3,6,3,0.9923850164576297,1,7,4,-0.43664940724135665,-3,1,-4,2,-1,4,1,-4,4,2,0,0.8412000000178814
9,R_2wvLMxIloZ7ffa5,34,f,1,1,764.6999999880791,Allow alt-right speakers on campus,Ban on ethnic Halloween costumes,-1,-1,3,5,3,0.9923850164576297,1,7,2,-0.43664940724135665,-3,-1,-2,2,-2,2,2,-2,2,2,0,0.764699999988079
9,R_2wvLMxIloZ7ffa5,35,f,1,1,758.1999999880791,Increased Gun regulations,Legalization of marijuana,-1,1,3,6,3,0.9923850164576297,3,5,3,0.9923850164576297,-3,3,-6,0,1,6,1,-6,6,0,0,0.7581999999880791
9,R_2wvLMxIloZ7ffa5,36,j,2,0,764.6000000238419,Allow alt-right speakers on campus,Detention of migrant children,-1,-1,3,5,3,0.9923850164576297,0,5,3,-1.1511666190908498,-3,-0,3,-3,0,3,0,-3,3,3,1,0.7646000000238419
9,R_2wvLMxIloZ7ffa5,37,f,1,1,769.9000000059605,Affirmative action,Affirmative action,1,-1,1,7,2,-0.43664940724135665,1,7,2,-0.43664940724135665,1,-1,2,0,0,2,0,2,-2,0,0,0.7699000000059605
9,R_2wvLMxIloZ7ffa5,38,f,1,1,1024.2999999821186,Mandatory trigger warnings,Allow alt-right speakers on campus,1,1,2,5,4,0.2778678046081365,3,5,3,0.9923850164576297,2,3,-1,-1,0,1,0,-1,1,-1,0,1.0242999999821185
9,R_2wvLMxIloZ7ffa5,39,j,2,0,911.0999999940395,Detention of migrant children,Increased Gun regulations,1,1,0,5,3,-1.1511666190908498,3,6,3,0.9923850164576297,0,3,3,3,1,3,1,-3,3,-3,1,0.9110999999940396
9,R_2wvLMxIloZ7ffa5,40,f,1,1,2362.9000000059605,Increased Gun regulations,Mask mandates,1,1,3,6,3,0.9923850164576297,3,5,3,0.9923850164576297,3,3,0,0,1,0,1,0,0,0,0,2.3629000000059603
9,R_2wvLMxIloZ7ffa5,41,j,2,0,925.9000000059605,Mandatory trigger warnings,Black Lives Matter,-1,-1,2,5,4,0.2778678046081365,1,7,4,-0.43664940724135665,-2,-1,1,-1,2,1,2,-1,1,1,1,0.9259000000059605
9,R_2wvLMxIloZ7ffa5,42,f,1,1,200.60000002384186,Mandatory vaccinations,Mandatory trigger warnings,1,1,0,7,3,-1.1511666190908498,2,5,4,0.2778678046081365,0,2,-2,-2,2,2,2,-2,2,-2,0,0.20060000002384185
9,R_2wvLMxIloZ7ffa5,43,j,2,0,821.5999999940395,Bathrooms restricted based on biological sex,Mandatory trigger warnings,-1,1,3,5,3,0.9923850164576297,2,5,4,0.2778678046081365,-3,2,5,-1,0,5,0,-5,5,1,1,0.8215999999940395
9,R_2wvLMxIloZ7ffa5,45,f,1,1,451.30000001192093,Increased Gun regulations,Gun-free campus police,1,-1,3,6,3,0.9923850164576297,0,7,3,-1.1511666190908498,3,-0,3,3,-1,3,1,3,-3,3,0,0.45130000001192094
9,R_2wvLMxIloZ7ffa5,46,f,1,1,876.4000000059605,Tuition increases,Mandatory vaccinations,1,1,1,7,4,-0.43664940724135665,0,7,3,-1.1511666190908498,1,0,1,1,0,1,0,1,-1,1,0,0.8764000000059604
9,R_2wvLMxIloZ7ffa5,47,f,1,1,1818.5999999940395,Bathrooms restricted based on biological sex,Black Lives Matter,-1,1,3,5,3,0.9923850164576297,1,7,4,-0.43664940724135665,-3,1,-4,2,-2,4,2,-4,4,2,0,1.8185999999940394
9,R_2wvLMxIloZ7ffa5,48,j,2,0,255.30000001192093,Dorms determined by gender identity,Affirmative action,1,-1,0,7,3,-1.1511666190908498,1,7,2,-0.43664940724135665,0,-1,-1,1,0,1,0,1,-1,-1,1,0.25530000001192094
9,R_2wvLMxIloZ7ffa5,49,f,1,1,824.2999999821186,Increased Gun regulations,Increased Gun regulations,1,-1,3,6,3,0.9923850164576297,3,6,3,0.9923850164576297,3,-3,6,0,0,6,0,6,-6,0,0,0.8242999999821186
9,R_2wvLMxIloZ7ffa5,50,f,1,1,1046.4000000059605,Mandatory trigger warnings,Mandatory trigger warnings,1,-1,2,5,4,0.2778678046081365,2,5,4,0.2778678046081365,2,-2,4,0,0,4,0,4,-4,0,0,1.0464000000059606
9,R_2wvLMxIloZ7ffa5,51,f,1,1,914.3000000119209,Detention of migrant children,Affirmative action,-1,1,0,5,3,-1.1511666190908498,1,7,2,-0.43664940724135665,-0,1,-1,-1,-2,1,2,-1,1,-1,0,0.9143000000119209
9,R_2wvLMxIloZ7ffa5,52,f,1,1,350.5,Legalization of marijuana,Hardening schools/Arming teachers,1,-1,3,5,3,0.9923850164576297,3,5,3,0.9923850164576297,3,-3,6,0,0,6,0,6,-6,0,0,0.3505
9,R_2wvLMxIloZ7ffa5,53,j,2,0,759.7999999821186,Mandatory trigger warnings,Black Lives Matter,-1,1,2,5,4,0.2778678046081365,1,7,4,-0.43664940724135665,-2,1,3,-1,2,3,2,-3,3,1,1,0.7597999999821186
9,R_2wvLMxIloZ7ffa5,54,f,1,1,814,Affirmative action,Increased Gun regulations,-1,-1,1,7,2,-0.43664940724135665,3,6,3,0.9923850164576297,-1,-3,2,-2,1,2,1,2,-2,-2,0,0.814
9,R_2wvLMxIloZ7ffa5,55,f,1,1,1188.199999988079,Increased Gun regulations,Allow alt-right speakers on campus,1,-1,3,6,3,0.9923850164576297,3,5,3,0.9923850164576297,3,-3,6,0,1,6,1,6,-6,0,0,1.188199999988079
9,R_2wvLMxIloZ7ffa5,56,j,2,0,1226.4000000059605,Ban on ethnic Halloween costumes,Remove public Confederate memorials,1,1,1,7,2,-0.43664940724135665,3,5,3,0.9923850164576297,1,3,2,2,-2,2,2,-2,2,-2,1,1.2264000000059605
9,R_2wvLMxIloZ7ffa5,58,f,1,1,611.0999999940395,Bathrooms restricted based on biological sex,Increased Gun regulations,-1,-1,3,5,3,0.9923850164576297,3,6,3,0.9923850164576297,-3,-3,0,0,-1,0,1,0,0,0,0,0.6110999999940395
9,R_2wvLMxIloZ7ffa5,59,f,1,1,1040.199999988079,Increased Gun regulations,Safe injection locations,1,1,3,6,3,0.9923850164576297,3,5,3,0.9923850164576297,3,3,0,0,1,0,1,0,0,0,0,1.040199999988079
9,R_2wvLMxIloZ7ffa5,60,j,2,0,857.4000000059605,Detention of migrant children,Increased Gun regulations,1,-1,0,5,3,-1.1511666190908498,3,6,3,0.9923850164576297,0,-3,-3,3,1,3,1,3,-3,-3,1,0.8574000000059605
9,R_2wvLMxIloZ7ffa5,61,f,1,1,465.80000001192093,Remove public Confederate memorials,Cuts to National Parks budget,-1,-1,3,5,3,0.9923850164576297,1,7,4,-0.43664940724135665,-3,-1,-2,2,-2,2,2,-2,2,2,0,0.46580000001192096
9,R_2wvLMxIloZ7ffa5,62,f,1,1,783.8000000119209,Increased Gun regulations,Religious exemptions for discrimination laws,-1,-1,3,6,3,0.9923850164576297,0,7,3,-1.1511666190908498,-3,-0,-3,3,-1,3,1,-3,3,3,0,0.783800000011921
9,R_2wvLMxIloZ7ffa5,63,f,1,1,1180.199999988079,Mandatory trigger warnings,Detention of migrant children,-1,-1,2,5,4,0.2778678046081365,0,5,3,-1.1511666190908498,-2,-0,-2,2,0,2,0,-2,2,2,0,1.180199999988079
9,R_2wvLMxIloZ7ffa5,64,j,2,0,810.5,Cuts to National Parks budget,Mandatory trigger warnings,1,1,1,7,4,-0.43664940724135665,2,5,4,0.2778678046081365,1,2,1,1,-2,1,2,-1,1,-1,1,0.8105
9,R_2wvLMxIloZ7ffa5,65,f,1,1,964.0999999940395,Raise the minimum wage,Mandatory trigger warnings,1,1,3,5,3,0.9923850164576297,2,5,4,0.2778678046081365,3,2,1,1,0,1,0,1,-1,1,0,0.9640999999940395
9,R_2wvLMxIloZ7ffa5,66,j,2,0,843.3000000119209,Religious exemptions for discrimination laws,Mask mandates,-1,1,0,7,3,-1.1511666190908498,3,5,3,0.9923850164576297,-0,3,3,3,-2,3,2,-3,3,-3,1,0.843300000011921
9,R_2wvLMxIloZ7ffa5,67,f,1,1,1119.5,Abortion rights,Detention of migrant children,1,1,3,5,3,0.9923850164576297,0,5,3,-1.1511666190908498,3,0,3,3,0,3,0,3,-3,3,0,1.1195
9,R_2wvLMxIloZ7ffa5,68,j,2,0,927.4000000059605,Cuts to National Parks budget,Mandatory trigger warnings,1,1,1,7,4,-0.43664940724135665,2,5,4,0.2778678046081365,1,2,1,1,-2,1,2,-1,1,-1,1,0.9274000000059605
9,R_2wvLMxIloZ7ffa5,69,f,1,1,955.1000000238419,Legalization of marijuana,Mandatory trigger warnings,-1,1,3,5,3,0.9923850164576297,2,5,4,0.2778678046081365,-3,2,-5,1,0,5,0,-5,5,1,0,0.9551000000238419
9,R_2wvLMxIloZ7ffa5,70,j,2,0,970.3000000119209,Ban on ethnic Halloween costumes,Legalization of marijuana,-1,1,1,7,2,-0.43664940724135665,3,5,3,0.9923850164576297,-1,3,4,2,-2,4,2,-4,4,-2,1,0.970300000011921
9,R_2wvLMxIloZ7ffa5,71,f,1,1,2621.5999999940395,Safe injection locations,War on Drugs,1,-1,3,5,3,0.9923850164576297,3,5,3,0.9923850164576297,3,-3,6,0,0,6,0,6,-6,0,0,2.6215999999940394
9,R_2wvLMxIloZ7ffa5,72,j,2,0,1022.8000000119209,Detention of migrant children,Affirmative action,-1,1,0,5,3,-1.1511666190908498,1,7,2,-0.43664940724135665,-0,1,1,1,2,1,2,-1,1,-1,1,1.0228000000119208
9,R_2wvLMxIloZ7ffa5,73,f,1,1,856,Mandatory trigger warnings,Abolishing private prisons,-1,-1,2,5,4,0.2778678046081365,0,7,3,-1.1511666190908498,-2,-0,-2,2,-2,2,2,-2,2,2,0,0.856
9,R_2wvLMxIloZ7ffa5,74,f,1,1,1307.300000011921,Defund the police,Cuts to National Parks budget,1,-1,0,7,3,-1.1511666190908498,1,7,4,-0.43664940724135665,0,-1,1,-1,0,1,0,1,-1,-1,0,1.307300000011921
9,R_2wvLMxIloZ7ffa5,75,j,2,0,683.5,Tuition increases,Increased Gun regulations,1,1,1,7,4,-0.43664940724135665,3,6,3,0.9923850164576297,1,3,2,2,-1,2,1,-2,2,-2,1,0.6835
9,R_2wvLMxIloZ7ffa5,76,j,2,0,669.7999999821186,Detention of migrant children,Religious exemptions for discrimination laws,1,-1,0,5,3,-1.1511666190908498,0,7,3,-1.1511666190908498,0,-0,-0,0,2,0,2,0,-0,0,1,0.6697999999821186
9,R_2wvLMxIloZ7ffa5,77,f,1,1,397.39999997615814,Increased Gun regulations,Legalization of marijuana,1,1,3,6,3,0.9923850164576297,3,5,3,0.9923850164576297,3,3,0,0,1,0,1,0,0,0,0,0.39739999997615816
9,R_2wvLMxIloZ7ffa5,78,j,2,0,924.2000000178814,Increased Gun regulations,Black Lives Matter,1,1,3,6,3,0.9923850164576297,1,7,4,-0.43664940724135665,3,1,-2,-2,1,2,1,2,-2,2,1,0.9242000000178814
9,R_2wvLMxIloZ7ffa5,79,j,2,0,814,Ban on research with animals,Climate change legislation,-1,1,3,5,3,0.9923850164576297,3,5,3,0.9923850164576297,-3,3,6,0,0,6,0,-6,6,0,1,0.814
9,R_2wvLMxIloZ7ffa5,80,f,1,1,3614.5999999940395,Detention of migrant children,"Boycott, Divest, and Sanction Israel",1,1,0,5,3,-1.1511666190908498,0,7,3,-1.1511666190908498,0,0,0,0,-2,0,2,0,0,0,0,3.6145999999940397
9,R_2wvLMxIloZ7ffa5,81,j,2,0,1593,Increased Gun regulations,Defund the police,-1,1,3,6,3,0.9923850164576297,0,7,3,-1.1511666190908498,-3,0,3,-3,1,3,1,-3,3,3,1,1.593
9,R_2wvLMxIloZ7ffa5,82,f,1,1,2618.100000023842,Mandatory trigger warnings,Abolishing private prisons,-1,1,2,5,4,0.2778678046081365,0,7,3,-1.1511666190908498,-2,0,-2,2,-2,2,2,-2,2,2,0,2.618100000023842
9,R_2wvLMxIloZ7ffa5,84,f,1,1,183.40000000596046,Mandatory trigger warnings,Mandatory trigger warnings,-1,1,2,5,4,0.2778678046081365,2,5,4,0.2778678046081365,-2,2,-4,0,0,4,0,-4,4,0,0,0.18340000000596046
9,R_2wvLMxIloZ7ffa5,85,j,2,0,196.69999998807907,Mandatory trigger warnings,Increased Gun regulations,-1,1,2,5,4,0.2778678046081365,3,6,3,0.9923850164576297,-2,3,5,1,1,5,1,-5,5,-1,1,0.19669999998807908
9,R_2wvLMxIloZ7ffa5,86,f,1,1,315.60000002384186,Stop police brutality,Mandatory trigger warnings,-1,-1,3,5,3,0.9923850164576297,2,5,4,0.2778678046081365,-3,-2,-1,1,0,1,0,-1,1,1,0,0.31560000002384186
9,R_2wvLMxIloZ7ffa5,87,j,2,0,181.30000001192093,Remove police from schools,Student worker unionization,1,-1,3,5,3,0.9923850164576297,0,7,3,-1.1511666190908498,3,-0,-3,-3,2,3,2,3,-3,3,1,0.18130000001192093
9,R_2wvLMxIloZ7ffa5,89,f,1,1,868.7999999821186,Detention of migrant children,Mandatory trigger warnings,-1,-1,0,5,3,-1.1511666190908498,2,5,4,0.2778678046081365,-0,-2,2,-2,0,2,0,2,-2,-2,0,0.8687999999821187
9,R_2wvLMxIloZ7ffa5,93,f,1,1,7295.799999982119,Mandatory trigger warnings,Tuition increases,1,-1,2,5,4,0.2778678046081365,1,7,4,-0.43664940724135665,2,-1,3,1,-2,3,2,3,-3,1,0,7.295799999982119
9,R_2wvLMxIloZ7ffa5,98,f,1,1,997.8000000119209,Increased Gun regulations,Mandatory trigger warnings,1,1,3,6,3,0.9923850164576297,2,5,4,0.2778678046081365,3,2,1,1,1,1,1,1,-1,1,0,0.9978000000119209
9,R_2wvLMxIloZ7ffa5,99,j,2,0,882.3000000119209,Mandatory trigger warnings,Increased Gun regulations,1,-1,2,5,4,0.2778678046081365,3,6,3,0.9923850164576297,2,-3,-5,1,1,5,1,5,-5,-1,1,0.8823000000119209
9,R_2wvLMxIloZ7ffa5,100,f,1,1,1050.4000000059605,Religious exemptions for discrimination laws,Raise the minimum wage,-1,-1,0,7,3,-1.1511666190908498,3,5,3,0.9923850164576297,-0,-3,3,-3,2,3,2,3,-3,-3,0,1.0504000000059606
13,R_4U6m0ByV1TgPxf3,1,j,2,0,4140,Black Lives Matter,Remove police from schools,-1,1,2,7,4,-0.3286710990610904,2,6,3,-0.3286710990610904,-2,2,4,0,-1,4,1,-4,4,0,1,4.14
13,R_4U6m0ByV1TgPxf3,2,f,1,1,12036,War on Drugs,Mandatory training on sexual consent,1,-1,3,7,4,1.6433554953054483,3,7,3,1.6433554953054483,3,-3,6,0,0,6,0,6,-6,0,0,12.036
13,R_4U6m0ByV1TgPxf3,3,f,1,1,7713,On campus concealed carry,Mask mandates,1,-1,3,8,4,1.6433554953054483,2,6,3,-0.3286710990610904,3,-2,5,1,2,5,2,5,-5,1,0,7.713
13,R_4U6m0ByV1TgPxf3,4,j,2,0,8695,Remove public Confederate memorials,Mandatory vaccinations,-1,1,2,8,4,-0.3286710990610904,1,6,3,-2.300697693427629,-2,1,3,-1,-2,3,2,-3,3,1,1,8.695
13,R_4U6m0ByV1TgPxf3,5,j,2,0,9902,Mandatory vaccinations,"Boycott, Divest, and Sanction Israel",-1,1,1,6,3,-2.300697693427629,2,8,4,-0.3286710990610904,-1,2,3,1,2,3,2,-3,3,-1,1,9.902
13,R_4U6m0ByV1TgPxf3,6,j,2,0,10708,Physician-assisted suicide,"Boycott, Divest, and Sanction Israel",-1,1,1,7,4,-2.300697693427629,2,8,4,-0.3286710990610904,-1,2,3,1,1,3,1,-3,3,-1,1,10.708
13,R_4U6m0ByV1TgPxf3,7,j,2,0,10816,Mandatory training on sexual consent,Physician-assisted suicide,-1,1,3,7,3,1.6433554953054483,1,7,4,-2.300697693427629,-3,1,4,-2,0,4,0,-4,4,2,1,10.816
13,R_4U6m0ByV1TgPxf3,8,f,1,1,9038,Mandatory vaccinations,War on Drugs,1,-1,1,6,3,-2.300697693427629,3,7,4,1.6433554953054483,1,-3,4,-2,-1,4,1,4,-4,-2,0,9.038
13,R_4U6m0ByV1TgPxf3,9,j,2,0,12416,War on Drugs,University Campus should be a Sanctuary,1,1,3,7,4,1.6433554953054483,2,7,4,-0.3286710990610904,3,2,-1,-1,0,1,0,1,-1,1,1,12.416
13,R_4U6m0ByV1TgPxf3,10,j,2,0,9310,Mandatory training on sexual consent,Physician-assisted suicide,1,1,3,7,3,1.6433554953054483,1,7,4,-2.300697693427629,3,1,-2,-2,0,2,0,2,-2,2,1,9.31
13,R_4U6m0ByV1TgPxf3,11,j,2,0,5662,Mandatory trigger warnings,Mandatory vaccinations,1,1,2,6,2,-0.3286710990610904,1,6,3,-2.300697693427629,2,1,-1,-1,0,1,0,1,-1,1,1,5.662
13,R_4U6m0ByV1TgPxf3,12,j,2,0,5110,Remove public Confederate memorials,Physician-assisted suicide,-1,1,2,8,4,-0.3286710990610904,1,7,4,-2.300697693427629,-2,1,3,-1,-1,3,1,-3,3,1,1,5.11
13,R_4U6m0ByV1TgPxf3,13,f,1,1,7094,Mandatory vaccinations,Abolishing private prisons,1,-1,1,6,3,-2.300697693427629,2,7,3,-0.3286710990610904,1,-2,3,-1,-1,3,1,3,-3,-1,0,7.094
13,R_4U6m0ByV1TgPxf3,14,j,2,0,6077,War on Drugs,Expel students with white nationlist views,-1,1,3,7,4,1.6433554953054483,2,6,3,-0.3286710990610904,-3,2,5,-1,-1,5,1,-5,5,1,1,6.077
13,R_4U6m0ByV1TgPxf3,15,j,2,0,3264,Remove Christopher Columbus statues,"Boycott, Divest, and Sanction Israel",1,1,3,8,4,1.6433554953054483,2,8,4,-0.3286710990610904,3,2,-1,-1,0,1,0,1,-1,1,1,3.264
13,R_4U6m0ByV1TgPxf3,16,j,2,0,5744,Remove public Confederate memorials,"Boycott, Divest, and Sanction Israel",-1,1,2,8,4,-0.3286710990610904,2,8,4,-0.3286710990610904,-2,2,4,0,0,4,0,-4,4,0,1,5.744
13,R_4U6m0ByV1TgPxf3,17,j,2,0,10482,Lift COVID lockdowns,Mandatory training on sexual consent,1,-1,3,8,4,1.6433554953054483,3,7,3,1.6433554953054483,3,-3,-6,0,-1,6,1,6,-6,0,1,10.482
13,R_4U6m0ByV1TgPxf3,18,j,2,0,7661,Physician-assisted suicide,Mandatory training on sexual consent,-1,1,1,7,4,-2.300697693427629,3,7,3,1.6433554953054483,-1,3,4,2,0,4,0,-4,4,-2,1,7.661
13,R_4U6m0ByV1TgPxf3,19,j,2,0,9399,Increased Gun regulations,War on Drugs,-1,1,2,7,4,-0.3286710990610904,3,7,4,1.6433554953054483,-2,3,5,1,0,5,0,-5,5,-1,1,9.399
13,R_4U6m0ByV1TgPxf3,20,f,1,1,7985,University Campus should be a Sanctuary,Physician-assisted suicide,-1,-1,2,7,4,-0.3286710990610904,1,7,4,-2.300697693427629,-2,-1,-1,1,0,1,0,-1,1,1,0,7.985
13,R_4U6m0ByV1TgPxf3,21,j,2,0,7492,Mandatory vaccinations,Remove public Confederate memorials,-1,-1,1,6,3,-2.300697693427629,2,8,4,-0.3286710990610904,-1,-2,-1,1,2,1,2,1,-1,-1,1,7.492
13,R_4U6m0ByV1TgPxf3,22,j,2,0,2529,Mandatory trigger warnings,Mandatory training on sexual consent,-1,-1,2,6,2,-0.3286710990610904,3,7,3,1.6433554953054483,-2,-3,-1,1,1,1,1,1,-1,-1,1,2.529
13,R_4U6m0ByV1TgPxf3,23,f,1,1,17274,Hardening schools/Arming teachers,"Boycott, Divest, and Sanction Israel",1,1,3,8,4,1.6433554953054483,2,8,4,-0.3286710990610904,3,2,1,1,0,1,0,1,-1,1,0,17.274
13,R_4U6m0ByV1TgPxf3,24,j,2,0,6689,Detention of migrant children,Black Lives Matter,1,1,3,8,4,1.6433554953054483,2,7,4,-0.3286710990610904,3,2,-1,-1,-1,1,1,1,-1,1,1,6.689
13,R_4U6m0ByV1TgPxf3,25,f,1,1,9511,Mandatory vaccinations,Black Lives Matter,-1,-1,1,6,3,-2.300697693427629,2,7,4,-0.3286710990610904,-1,-2,1,-1,-1,1,1,1,-1,-1,0,9.511
13,R_4U6m0ByV1TgPxf3,26,j,2,0,5613,War on Drugs,Religious exemptions for discrimination laws,1,1,3,7,4,1.6433554953054483,3,8,3,1.6433554953054483,3,3,0,0,1,0,1,0,0,0,1,5.613
13,R_4U6m0ByV1TgPxf3,27,j,2,0,11401,Safe injection locations,Remove Christopher Columbus statues,-1,1,2,7,4,-0.3286710990610904,3,8,4,1.6433554953054483,-2,3,5,1,1,5,1,-5,5,-1,1,11.401
13,R_4U6m0ByV1TgPxf3,28,f,1,1,5327,Safe injection locations,Dorms determined by gender identity,-1,-1,2,7,4,-0.3286710990610904,2,6,3,-0.3286710990610904,-2,-2,0,0,1,0,1,0,0,0,0,5.327
13,R_4U6m0ByV1TgPxf3,29,f,1,1,8180,On campus concealed carry,Climate change legislation,-1,-1,3,8,4,1.6433554953054483,2,7,3,-0.3286710990610904,-3,-2,-1,1,1,1,1,-1,1,1,0,8.18
13,R_4U6m0ByV1TgPxf3,30,f,1,1,4164,Physician-assisted suicide,Remove public Confederate memorials,1,1,1,7,4,-2.300697693427629,2,8,4,-0.3286710990610904,1,2,-1,-1,-1,1,1,-1,1,-1,0,4.164
13,R_4U6m0ByV1TgPxf3,31,j,2,0,12406,Dorms determined by gender identity,Religious exemptions for discrimination laws,1,-1,2,6,3,-0.3286710990610904,3,8,3,1.6433554953054483,2,-3,-5,1,2,5,2,5,-5,-1,1,12.406
13,R_4U6m0ByV1TgPxf3,32,f,1,1,11115,War on Drugs,Build southern border wall,1,-1,3,7,4,1.6433554953054483,2,6,3,-0.3286710990610904,3,-2,5,1,1,5,1,5,-5,1,0,11.115
13,R_4U6m0ByV1TgPxf3,33,j,2,0,9450,Remove police from schools,Dorms determined by gender identity,1,-1,2,6,3,-0.3286710990610904,2,6,3,-0.3286710990610904,2,-2,-4,0,0,4,0,4,-4,0,1,9.45
13,R_4U6m0ByV1TgPxf3,34,j,2,0,4005,Remove police from schools,Climate change legislation,-1,1,2,6,3,-0.3286710990610904,2,7,3,-0.3286710990610904,-2,2,4,0,1,4,1,-4,4,0,1,4.005
13,R_4U6m0ByV1TgPxf3,35,j,2,0,2775,Physician-assisted suicide,Physician-assisted suicide,-1,1,1,7,4,-2.300697693427629,1,7,4,-2.300697693427629,-1,1,2,0,0,2,0,-2,2,0,1,2.775
13,R_4U6m0ByV1TgPxf3,36,f,1,1,10843,Mandatory vaccinations,Physician-assisted suicide,1,-1,1,6,3,-2.300697693427629,1,7,4,-2.300697693427629,1,-1,2,0,-1,2,1,2,-2,0,0,10.843
13,R_4U6m0ByV1TgPxf3,37,f,1,1,4568,Remove public Confederate memorials,Expel students with white nationlist views,-1,1,2,8,4,-0.3286710990610904,2,6,3,-0.3286710990610904,-2,2,-4,0,2,4,2,-4,4,0,0,4.568
13,R_4U6m0ByV1TgPxf3,38,j,2,0,11342,Mandatory training on sexual consent,Hardening schools/Arming teachers,1,1,3,7,3,1.6433554953054483,3,8,4,1.6433554953054483,3,3,0,0,1,0,1,0,0,0,1,11.342
13,R_4U6m0ByV1TgPxf3,39,f,1,1,9161,On campus concealed carry,Mandatory training on sexual consent,-1,-1,3,8,4,1.6433554953054483,3,7,3,1.6433554953054483,-3,-3,0,0,1,0,1,0,0,0,0,9.161
13,R_4U6m0ByV1TgPxf3,40,j,2,0,10995,"Boycott, Divest, and Sanction Israel",Religious exemptions for discrimination laws,-1,1,2,8,4,-0.3286710990610904,3,8,3,1.6433554953054483,-2,3,5,1,0,5,0,-5,5,-1,1,10.995
13,R_4U6m0ByV1TgPxf3,41,f,1,1,1277,War on Drugs,Mandatory vaccinations,1,-1,3,7,4,1.6433554953054483,1,6,3,-2.300697693427629,3,-1,4,2,1,4,1,4,-4,2,0,1.277
13,R_4U6m0ByV1TgPxf3,42,f,1,1,9828,Build southern border wall,Physician-assisted suicide,-1,-1,2,6,3,-0.3286710990610904,1,7,4,-2.300697693427629,-2,-1,-1,1,-1,1,1,-1,1,1,0,9.828
13,R_4U6m0ByV1TgPxf3,43,j,2,0,3392,War on Drugs,Ban on ethnic Halloween costumes,-1,-1,3,7,4,1.6433554953054483,2,7,4,-0.3286710990610904,-3,-2,1,-1,0,1,0,-1,1,1,1,3.392
13,R_4U6m0ByV1TgPxf3,44,f,1,1,1697,War on Drugs,Mandatory vaccinations,1,1,3,7,4,1.6433554953054483,1,6,3,-2.300697693427629,3,1,2,2,1,2,1,2,-2,2,0,1.697
13,R_4U6m0ByV1TgPxf3,45,j,2,0,2674,Mask mandates,On campus concealed carry,1,1,2,6,3,-0.3286710990610904,3,8,4,1.6433554953054483,2,3,1,1,2,1,2,-1,1,-1,1,2.674
13,R_4U6m0ByV1TgPxf3,46,f,1,1,5388,War on Drugs,Increased Gun regulations,-1,1,3,7,4,1.6433554953054483,2,7,4,-0.3286710990610904,-3,2,-5,1,0,5,0,-5,5,1,0,5.388
13,R_4U6m0ByV1TgPxf3,47,j,2,0,1322,Remove Christopher Columbus statues,On campus concealed carry,-1,1,3,8,4,1.6433554953054483,3,8,4,1.6433554953054483,-3,3,6,0,0,6,0,-6,6,0,1,1.322
13,R_4U6m0ByV1TgPxf3,48,f,1,1,4891,Safe injection locations,Physician-assisted suicide,1,-1,2,7,4,-0.3286710990610904,1,7,4,-2.300697693427629,2,-1,3,1,0,3,0,3,-3,1,0,4.891
13,R_4U6m0ByV1TgPxf3,49,j,2,0,9405,Gun-free campus police,Detention of migrant children,-1,1,2,6,2,-0.3286710990610904,3,8,4,1.6433554953054483,-2,3,5,1,2,5,2,-5,5,-1,1,9.405
13,R_4U6m0ByV1TgPxf3,50,f,1,1,5680,Mandatory vaccinations,Remove public Confederate memorials,1,1,1,6,3,-2.300697693427629,2,8,4,-0.3286710990610904,1,2,-1,-1,-2,1,2,-1,1,-1,0,5.68
13,R_4U6m0ByV1TgPxf3,51,f,1,1,2528,Mandatory training on sexual consent,Physician-assisted suicide,-1,-1,3,7,3,1.6433554953054483,1,7,4,-2.300697693427629,-3,-1,-2,2,0,2,0,-2,2,2,0,2.528
13,R_4U6m0ByV1TgPxf3,52,j,2,0,1534,Remove public Confederate memorials,Student worker unionization,1,-1,2,8,4,-0.3286710990610904,2,7,4,-0.3286710990610904,2,-2,-4,0,-1,4,1,4,-4,0,1,1.534
13,R_4U6m0ByV1TgPxf3,53,j,2,0,5949,Recognize Jerusalem as capital of Israel,Physician-assisted suicide,1,1,2,6,3,-0.3286710990610904,1,7,4,-2.300697693427629,2,1,-1,-1,1,1,1,1,-1,1,1,5.949
13,R_4U6m0ByV1TgPxf3,54,f,1,1,4485,War on Drugs,"Boycott, Divest, and Sanction Israel",-1,1,3,7,4,1.6433554953054483,2,8,4,-0.3286710990610904,-3,2,-5,1,-1,5,1,-5,5,1,0,4.485
13,R_4U6m0ByV1TgPxf3,55,f,1,1,2326,"Boycott, Divest, and Sanction Israel",Religious exemptions for discrimination laws,-1,-1,2,8,4,-0.3286710990610904,3,8,3,1.6433554953054483,-2,-3,1,-1,0,1,0,1,-1,-1,0,2.326
13,R_4U6m0ByV1TgPxf3,56,f,1,1,4113,Religious exemptions for discrimination laws,Expel students with white nationlist views,-1,-1,3,8,3,1.6433554953054483,2,6,3,-0.3286710990610904,-3,-2,-1,1,2,1,2,-1,1,1,0,4.113
13,R_4U6m0ByV1TgPxf3,57,j,2,0,2064,Lift COVID lockdowns,Physician-assisted suicide,1,-1,3,8,4,1.6433554953054483,1,7,4,-2.300697693427629,3,-1,-4,-2,-1,4,1,4,-4,2,1,2.064
13,R_4U6m0ByV1TgPxf3,58,j,2,0,2884,Mandatory vaccinations,War on Drugs,-1,-1,1,6,3,-2.300697693427629,3,7,4,1.6433554953054483,-1,-3,-2,2,1,2,1,2,-2,-2,1,2.884
13,R_4U6m0ByV1TgPxf3,59,f,1,1,2507,Remove public Confederate memorials,Bathrooms restricted based on biological sex,-1,1,2,8,4,-0.3286710990610904,2,7,4,-0.3286710990610904,-2,2,-4,0,1,4,1,-4,4,0,0,2.507
13,R_4U6m0ByV1TgPxf3,60,j,2,0,4044,Build southern border wall,Mandatory vaccinations,1,-1,2,6,3,-0.3286710990610904,1,6,3,-2.300697693427629,2,-1,-3,-1,0,3,0,3,-3,1,1,4.044
13,R_4U6m0ByV1TgPxf3,61,f,1,1,3608,Mandatory vaccinations,Hardening schools/Arming teachers,-1,1,1,6,3,-2.300697693427629,3,8,4,1.6433554953054483,-1,3,-4,-2,-2,4,2,-4,4,-2,0,3.608
13,R_4U6m0ByV1TgPxf3,62,f,1,1,3914,Physician-assisted suicide,Remove Christopher Columbus statues,1,-1,1,7,4,-2.300697693427629,3,8,4,1.6433554953054483,1,-3,4,-2,-1,4,1,4,-4,-2,0,3.914
13,R_4U6m0ByV1TgPxf3,63,f,1,1,2662,Mandatory vaccinations,Mandatory vaccinations,1,-1,1,6,3,-2.300697693427629,1,6,3,-2.300697693427629,1,-1,2,0,0,2,0,2,-2,0,0,2.662
13,R_4U6m0ByV1TgPxf3,64,f,1,1,3609,Black Lives Matter,Religious exemptions for discrimination laws,1,-1,2,7,4,-0.3286710990610904,3,8,3,1.6433554953054483,2,-3,5,-1,-1,5,1,5,-5,-1,0,3.609
13,R_4U6m0ByV1TgPxf3,65,j,2,0,1861,Mandatory trigger warnings,Remove public Confederate memorials,1,1,2,6,2,-0.3286710990610904,2,8,4,-0.3286710990610904,2,2,0,0,2,0,2,0,0,0,1,1.861
13,R_4U6m0ByV1TgPxf3,66,f,1,1,4425,Remove public Confederate memorials,Climate change legislation,1,1,2,8,4,-0.3286710990610904,2,7,3,-0.3286710990610904,2,2,0,0,1,0,1,0,0,0,0,4.425
13,R_4U6m0ByV1TgPxf3,67,f,1,1,1828,Lift COVID lockdowns,Hardening schools/Arming teachers,1,-1,3,8,4,1.6433554953054483,3,8,4,1.6433554953054483,3,-3,6,0,0,6,0,6,-6,0,0,1.828
13,R_4U6m0ByV1TgPxf3,68,j,2,0,3258,Remove public Confederate memorials,Expel students with white nationlist views,1,-1,2,8,4,-0.3286710990610904,2,6,3,-0.3286710990610904,2,-2,-4,0,-2,4,2,4,-4,0,1,3.258
13,R_4U6m0ByV1TgPxf3,69,f,1,1,1647,Physician-assisted suicide,Ban on ethnic Halloween costumes,1,1,1,7,4,-2.300697693427629,2,7,4,-0.3286710990610904,1,2,-1,-1,0,1,0,-1,1,-1,0,1.647
13,R_4U6m0ByV1TgPxf3,70,f,1,1,2836,Mandatory vaccinations,On campus concealed carry,1,-1,1,6,3,-2.300697693427629,3,8,4,1.6433554953054483,1,-3,4,-2,-2,4,2,4,-4,-2,0,2.836
13,R_4U6m0ByV1TgPxf3,71,f,1,1,1097,"Boycott, Divest, and Sanction Israel",Mandatory training on sexual consent,1,1,2,8,4,-0.3286710990610904,3,7,3,1.6433554953054483,2,3,-1,-1,1,1,1,-1,1,-1,0,1.097
13,R_4U6m0ByV1TgPxf3,72,j,2,0,1307,Expel students with white nationlist views,On campus concealed carry,1,1,2,6,3,-0.3286710990610904,3,8,4,1.6433554953054483,2,3,1,1,2,1,2,-1,1,-1,1,1.307
13,R_4U6m0ByV1TgPxf3,73,f,1,1,4897,Mandatory vaccinations,Mandatory trigger warnings,1,-1,1,6,3,-2.300697693427629,2,6,2,-0.3286710990610904,1,-2,3,-1,0,3,0,3,-3,-1,0,4.897
13,R_4U6m0ByV1TgPxf3,74,f,1,1,3368,Affirmative action,Recognize Jerusalem as capital of Israel,1,1,2,7,4,-0.3286710990610904,2,6,3,-0.3286710990610904,2,2,0,0,1,0,1,0,0,0,0,3.368
13,R_4U6m0ByV1TgPxf3,75,f,1,1,2258,On campus concealed carry,Mandatory vaccinations,-1,-1,3,8,4,1.6433554953054483,1,6,3,-2.300697693427629,-3,-1,-2,2,2,2,2,-2,2,2,0,2.258
13,R_4U6m0ByV1TgPxf3,76,f,1,1,1879,Mandatory vaccinations,Abortion rights,-1,1,1,6,3,-2.300697693427629,2,7,4,-0.3286710990610904,-1,2,-3,-1,-1,3,1,-3,3,-1,0,1.879
13,R_4U6m0ByV1TgPxf3,77,f,1,1,2044,Physician-assisted suicide,Mandatory vaccinations,-1,-1,1,7,4,-2.300697693427629,1,6,3,-2.300697693427629,-1,-1,0,0,1,0,1,0,0,0,0,2.044
13,R_4U6m0ByV1TgPxf3,78,f,1,1,2629,Build southern border wall,Mandatory training on sexual consent,1,1,2,6,3,-0.3286710990610904,3,7,3,1.6433554953054483,2,3,-1,-1,-1,1,1,-1,1,-1,0,2.629
13,R_4U6m0ByV1TgPxf3,79,f,1,1,2036,Black Lives Matter,Remove Christopher Columbus statues,1,1,2,7,4,-0.3286710990610904,3,8,4,1.6433554953054483,2,3,-1,-1,-1,1,1,-1,1,-1,0,2.036
13,R_4U6m0ByV1TgPxf3,80,f,1,1,2647,"Boycott, Divest, and Sanction Israel",Black Lives Matter,-1,-1,2,8,4,-0.3286710990610904,2,7,4,-0.3286710990610904,-2,-2,0,0,1,0,1,0,0,0,0,2.647
13,R_4U6m0ByV1TgPxf3,81,f,1,1,3714,"Boycott, Divest, and Sanction Israel",Lift COVID lockdowns,1,-1,2,8,4,-0.3286710990610904,3,8,4,1.6433554953054483,2,-3,5,-1,0,5,0,5,-5,-1,0,3.714
13,R_4U6m0ByV1TgPxf3,82,j,2,0,1530,Dorms determined by gender identity,Mandatory vaccinations,-1,-1,2,6,3,-0.3286710990610904,1,6,3,-2.300697693427629,-2,-1,1,-1,0,1,0,-1,1,1,1,1.53
13,R_4U6m0ByV1TgPxf3,83,f,1,1,1694,Physician-assisted suicide,Student worker unionization,1,-1,1,7,4,-2.300697693427629,2,7,4,-0.3286710990610904,1,-2,3,-1,0,3,0,3,-3,-1,0,1.694
13,R_4U6m0ByV1TgPxf3,84,f,1,1,6974,Physician-assisted suicide,Gun-free campus police,-1,1,1,7,4,-2.300697693427629,2,6,2,-0.3286710990610904,-1,2,-3,-1,1,3,1,-3,3,-1,0,6.974
13,R_4U6m0ByV1TgPxf3,85,j,2,0,1174,Religious exemptions for discrimination laws,Stop police brutality,1,-1,3,8,3,1.6433554953054483,2,7,3,-0.3286710990610904,3,-2,-5,-1,-1,5,1,5,-5,1,1,1.174
13,R_4U6m0ByV1TgPxf3,87,j,2,0,748,Physician-assisted suicide,On campus concealed carry,1,1,1,7,4,-2.300697693427629,3,8,4,1.6433554953054483,1,3,2,2,1,2,1,-2,2,-2,1,0.748
13,R_4U6m0ByV1TgPxf3,88,f,1,1,890,Remove public Confederate memorials,Physician-assisted suicide,-1,-1,2,8,4,-0.3286710990610904,1,7,4,-2.300697693427629,-2,-1,-1,1,1,1,1,-1,1,1,0,0.89
13,R_4U6m0ByV1TgPxf3,89,j,2,0,766,"Boycott, Divest, and Sanction Israel",War on Drugs,-1,1,2,8,4,-0.3286710990610904,3,7,4,1.6433554953054483,-2,3,5,1,-1,5,1,-5,5,-1,1,0.766
13,R_4U6m0ByV1TgPxf3,90,f,1,1,1542,Affirmative action,Safe injection locations,-1,1,2,7,4,-0.3286710990610904,2,7,4,-0.3286710990610904,-2,2,-4,0,0,4,0,-4,4,0,0,1.542
13,R_4U6m0ByV1TgPxf3,91,f,1,1,2124,Detention of migrant children,Mandatory vaccinations,1,1,3,8,4,1.6433554953054483,1,6,3,-2.300697693427629,3,1,2,2,2,2,2,2,-2,2,0,2.124
13,R_4U6m0ByV1TgPxf3,92,f,1,1,3108,Religious exemptions for discrimination laws,"Boycott, Divest, and Sanction Israel",1,-1,3,8,3,1.6433554953054483,2,8,4,-0.3286710990610904,3,-2,5,1,0,5,0,5,-5,1,0,3.108
13,R_4U6m0ByV1TgPxf3,93,j,2,0,1575,War on Drugs,Remove Christopher Columbus statues,-1,1,3,7,4,1.6433554953054483,3,8,4,1.6433554953054483,-3,3,6,0,1,6,1,-6,6,0,1,1.575
13,R_4U6m0ByV1TgPxf3,94,j,2,0,4023,Ban on ethnic Halloween costumes,Mandatory vaccinations,1,1,2,7,4,-0.3286710990610904,1,6,3,-2.300697693427629,2,1,-1,-1,-1,1,1,1,-1,1,1,4.023
13,R_4U6m0ByV1TgPxf3,95,f,1,1,2047,Mandatory vaccinations,Physician-assisted suicide,-1,1,1,6,3,-2.300697693427629,1,7,4,-2.300697693427629,-1,1,-2,0,-1,2,1,-2,2,0,0,2.047
13,R_4U6m0ByV1TgPxf3,96,f,1,1,2108,Remove public Confederate memorials,Mandatory training on sexual consent,-1,-1,2,8,4,-0.3286710990610904,3,7,3,1.6433554953054483,-2,-3,1,-1,1,1,1,1,-1,-1,0,2.108
13,R_4U6m0ByV1TgPxf3,97,j,2,0,1255,Mask mandates,Remove public Confederate memorials,-1,-1,2,6,3,-0.3286710990610904,2,8,4,-0.3286710990610904,-2,-2,0,0,2,0,2,0,0,0,1,1.255
13,R_4U6m0ByV1TgPxf3,98,f,1,1,3340,Physician-assisted suicide,Dorms determined by gender identity,1,-1,1,7,4,-2.300697693427629,2,6,3,-0.3286710990610904,1,-2,3,-1,1,3,1,3,-3,-1,0,3.34
13,R_4U6m0ByV1TgPxf3,99,j,2,0,2007,Detention of migrant children,Physician-assisted suicide,-1,-1,3,8,4,1.6433554953054483,1,7,4,-2.300697693427629,-3,-1,2,-2,-1,2,1,-2,2,2,1,2.007
13,R_4U6m0ByV1TgPxf3,100,f,1,1,3908,On campus concealed carry,Mandatory training on sexual consent,-1,1,3,8,4,1.6433554953054483,3,7,3,1.6433554953054483,-3,3,-6,0,1,6,1,-6,6,0,0,3.908
5,R_22YukpAa4vp3drL,1,j,2,0,4552.20000000298,Black Lives Matter,Expel students with white nationlist views,1,1,3,8,4,1.1293358837949117,2,8,3,0.6292014209714508,3,2,-1,-1,0,1,0,1,-1,1,1,4.55220000000298
5,R_22YukpAa4vp3drL,2,f,1,1,3946.1000000089407,Religious exemptions for discrimination laws,Detention of migrant children,-1,1,1,4,2,0.12906695814799,-3,7,2,-1.8714708931458532,-1,-3,2,4,-3,2,3,2,-2,4,0,3.946100000008941
5,R_22YukpAa4vp3drL,3,j,2,0,2964.2000000029802,Mask mandates,Build southern border wall,1,-1,0,5,4,-0.3710675046754708,-3,8,3,-1.8714708931458532,0,3,3,-3,3,3,3,-3,3,3,1,2.9642000000029802
5,R_22YukpAa4vp3drL,4,f,1,1,4233.699999988079,Ban on ethnic Halloween costumes,Climate change legislation,1,-1,0,4,1,-0.3710675046754708,3,6,4,1.1293358837949117,0,-3,3,-3,-2,3,2,3,-3,-3,0,4.233699999988079
5,R_22YukpAa4vp3drL,5,j,2,0,2750.7999999970198,Expel students with white nationlist views,Ban on research with animals,-1,1,2,8,3,0.6292014209714508,3,8,4,1.1293358837949117,-2,3,5,1,0,5,0,-5,5,-1,1,2.7507999999970196
5,R_22YukpAa4vp3drL,6,f,1,1,2614.0999999940395,Detention of migrant children,Detention of migrant children,-1,1,-3,7,2,-1.8714708931458532,-3,7,2,-1.8714708931458532,3,-3,6,0,0,6,0,6,-6,0,0,2.6140999999940395
5,R_22YukpAa4vp3drL,7,j,2,0,1973.2000000029802,Affirmative action,Climate change legislation,-1,1,2,6,3,0.6292014209714508,3,6,4,1.1293358837949117,-2,3,5,1,0,5,0,-5,5,-1,1,1.9732000000029801
5,R_22YukpAa4vp3drL,8,f,1,1,3339.7999999970198,Religious exemptions for discrimination laws,Defund Planned Parenthood,1,-1,1,4,2,0.12906695814799,-3,8,3,-1.8714708931458532,1,3,-2,4,-4,2,4,-2,2,4,0,3.3397999999970196
5,R_22YukpAa4vp3drL,9,f,1,1,3418.5999999940395,Detention of migrant children,Abolishing fraternities,-1,-1,-3,7,2,-1.8714708931458532,0,5,3,-0.3710675046754708,3,-0,3,-3,2,3,2,3,-3,-3,0,3.4185999999940395
5,R_22YukpAa4vp3drL,10,j,2,0,3020.6000000089407,On campus concealed carry,Detention of migrant children,-1,-1,0,2,2,-0.3710675046754708,-3,7,2,-1.8714708931458532,-0,3,3,-3,5,3,5,-3,3,3,1,3.020600000008941
5,R_22YukpAa4vp3drL,11,f,1,1,2281,Ban on research with animals,U.S. drone strikes in Afghanistan,1,1,3,8,4,1.1293358837949117,1,5,2,0.12906695814799,3,1,2,2,3,2,3,2,-2,2,0,2.281
5,R_22YukpAa4vp3drL,12,j,2,0,4085.2999999970198,U.S. drone strikes in Afghanistan,Climate change legislation,1,1,1,5,2,0.12906695814799,3,6,4,1.1293358837949117,1,3,2,2,1,2,1,-2,2,-2,1,4.085299999997019
5,R_22YukpAa4vp3drL,13,j,2,0,3091,Climate change legislation,Climate change legislation,-1,1,3,6,4,1.1293358837949117,3,6,4,1.1293358837949117,-3,3,6,0,0,6,0,-6,6,0,1,3.091
5,R_22YukpAa4vp3drL,14,f,1,1,2339.7999999970198,Religious exemptions for discrimination laws,Climate change legislation,1,-1,1,4,2,0.12906695814799,3,6,4,1.1293358837949117,1,-3,4,-2,-2,4,2,4,-4,-2,0,2.3397999999970196
5,R_22YukpAa4vp3drL,15,j,2,0,2035.699999988079,Climate change legislation,Build southern border wall,-1,-1,3,6,4,1.1293358837949117,-3,8,3,-1.8714708931458532,-3,3,6,-6,2,6,2,-6,6,6,1,2.035699999988079
5,R_22YukpAa4vp3drL,16,f,1,1,1339,Climate change legislation,Abolishing private prisons,1,-1,3,6,4,1.1293358837949117,2,7,3,0.6292014209714508,3,-2,5,1,-1,5,1,5,-5,1,0,1.339
5,R_22YukpAa4vp3drL,17,j,2,0,3449.8999999910593,Mandatory training on sexual consent,Ban on research with animals,1,1,0,0,1,-0.3710675046754708,3,8,4,1.1293358837949117,0,3,3,3,8,3,8,-3,3,-3,1,3.449899999991059
5,R_22YukpAa4vp3drL,18,f,1,1,5496,Expel students with white nationlist views,Climate change legislation,-1,-1,2,8,3,0.6292014209714508,3,6,4,1.1293358837949117,-2,-3,1,-1,2,1,2,1,-1,-1,0,5.496
5,R_22YukpAa4vp3drL,19,j,2,0,1847.8999999910593,Religious exemptions for discrimination laws,Climate change legislation,-1,1,1,4,2,0.12906695814799,3,6,4,1.1293358837949117,-1,3,4,2,2,4,2,-4,4,-2,1,1.8478999999910592
5,R_22YukpAa4vp3drL,20,j,2,0,2243.199999988079,Remove Christopher Columbus statues,Gun-free campus police,-1,1,3,8,4,1.1293358837949117,2,6,1,0.6292014209714508,-3,2,5,-1,-2,5,2,-5,5,1,1,2.243199999988079
5,R_22YukpAa4vp3drL,21,f,1,1,1861.5999999940395,Religious exemptions for discrimination laws,Climate change legislation,-1,-1,1,4,2,0.12906695814799,3,6,4,1.1293358837949117,-1,-3,2,-2,-2,2,2,2,-2,-2,0,1.8615999999940396
5,R_22YukpAa4vp3drL,22,j,2,0,3808.9000000059605,Detention of migrant children,Gun-free campus police,1,-1,-3,7,2,-1.8714708931458532,2,6,1,0.6292014209714508,-3,-2,1,5,-1,1,1,-1,1,-5,1,3.8089000000059605
5,R_22YukpAa4vp3drL,23,f,1,1,2204.699999988079,Expel students with white nationlist views,Ban on research with animals,-1,-1,2,8,3,0.6292014209714508,3,8,4,1.1293358837949117,-2,-3,1,-1,0,1,0,1,-1,-1,0,2.204699999988079
5,R_22YukpAa4vp3drL,24,j,2,0,2857.7000000029802,Abolishing private prisons,Detention of migrant children,-1,-1,2,7,3,0.6292014209714508,-3,7,2,-1.8714708931458532,-2,3,5,-5,0,5,0,-5,5,5,1,2.85770000000298
5,R_22YukpAa4vp3drL,25,j,2,0,1803.699999988079,Climate change legislation,Remove police from schools,-1,1,3,6,4,1.1293358837949117,2,7,3,0.6292014209714508,-3,2,5,-1,1,5,1,-5,5,1,1,1.8036999999880792
5,R_22YukpAa4vp3drL,26,j,2,0,2304.6000000089407,Raise the minimum wage,Ban on ethnic Halloween costumes,-1,1,3,8,4,1.1293358837949117,0,4,1,-0.3710675046754708,-3,0,3,-3,-4,3,4,-3,3,3,1,2.3046000000089406
5,R_22YukpAa4vp3drL,27,j,2,0,1684.5999999940395,Physician-assisted suicide,Climate change legislation,1,1,0,7,4,-0.3710675046754708,3,6,4,1.1293358837949117,0,3,3,3,-1,3,1,-3,3,-3,1,1.6845999999940395
5,R_22YukpAa4vp3drL,28,j,2,0,1522.2000000029802,Detention of migrant children,Remove Christopher Columbus statues,-1,1,-3,7,2,-1.8714708931458532,3,8,4,1.1293358837949117,3,3,0,6,1,0,1,0,0,-6,1,1.5222000000029803
5,R_22YukpAa4vp3drL,29,f,1,1,1933.2000000029802,Ban on ethnic Halloween costumes,Detention of migrant children,1,-1,0,4,1,-0.3710675046754708,-3,7,2,-1.8714708931458532,0,3,-3,3,-3,3,3,-3,3,3,0,1.9332000000029803
5,R_22YukpAa4vp3drL,30,f,1,1,1944.2000000029802,Safe injection locations,Climate change legislation,1,-1,1,5,2,0.12906695814799,3,6,4,1.1293358837949117,1,-3,4,-2,-1,4,1,4,-4,-2,0,1.9442000000029802
5,R_22YukpAa4vp3drL,31,j,2,0,2332.7000000029802,Climate change legislation,Gun-free campus police,-1,-1,3,6,4,1.1293358837949117,2,6,1,0.6292014209714508,-3,-2,1,-1,0,1,0,-1,1,1,1,2.3327000000029803
5,R_22YukpAa4vp3drL,32,f,1,1,2473,Religious exemptions for discrimination laws,Legalization of marijuana,1,-1,1,4,2,0.12906695814799,3,8,4,1.1293358837949117,1,-3,4,-2,-4,4,4,4,-4,-2,0,2.473
5,R_22YukpAa4vp3drL,33,f,1,1,1886.0999999940395,Detention of migrant children,Expel students with white nationlist views,-1,-1,-3,7,2,-1.8714708931458532,2,8,3,0.6292014209714508,3,-2,5,-5,-1,5,1,5,-5,-5,0,1.8860999999940395
5,R_22YukpAa4vp3drL,34,f,1,1,3071.199999988079,Affirmative action,Remove Christopher Columbus statues,-1,-1,2,6,3,0.6292014209714508,3,8,4,1.1293358837949117,-2,-3,1,-1,-2,1,2,1,-1,-1,0,3.071199999988079
5,R_22YukpAa4vp3drL,35,f,1,1,1486.6000000089407,Ban on ethnic Halloween costumes,Cuts to National Parks budget,1,-1,0,4,1,-0.3710675046754708,-3,8,3,-1.8714708931458532,0,3,-3,3,-4,3,4,-3,3,3,0,1.4866000000089408
5,R_22YukpAa4vp3drL,36,j,2,0,1829.0999999940395,Detention of migrant children,Abolishing private prisons,1,1,-3,7,2,-1.8714708931458532,2,7,3,0.6292014209714508,-3,2,5,5,0,5,0,-5,5,-5,1,1.8290999999940396
5,R_22YukpAa4vp3drL,37,j,2,0,2537.4000000059605,"Boycott, Divest, and Sanction Israel",Detention of migrant children,1,-1,0,0,1,-0.3710675046754708,-3,7,2,-1.8714708931458532,0,3,3,-3,7,3,7,-3,3,3,1,2.5374000000059604
5,R_22YukpAa4vp3drL,38,f,1,1,2163.1000000089407,U.S. drone strikes in Afghanistan,Detention of migrant children,-1,1,1,5,2,0.12906695814799,-3,7,2,-1.8714708931458532,-1,-3,2,4,-2,2,2,2,-2,4,0,2.163100000008941
5,R_22YukpAa4vp3drL,39,f,1,1,1620.5,Climate change legislation,Expel students with white nationlist views,1,-1,3,6,4,1.1293358837949117,2,8,3,0.6292014209714508,3,-2,5,1,-2,5,2,5,-5,1,0,1.6205
5,R_22YukpAa4vp3drL,40,f,1,1,2057.7999999970198,Climate change legislation,Legalization of marijuana,-1,-1,3,6,4,1.1293358837949117,3,8,4,1.1293358837949117,-3,-3,0,0,-2,0,2,0,0,0,0,2.0577999999970196
5,R_22YukpAa4vp3drL,41,f,1,1,1925.4000000059605,Lift COVID lockdowns,Climate change legislation,1,-1,2,6,4,0.6292014209714508,3,6,4,1.1293358837949117,2,-3,5,-1,0,5,0,5,-5,-1,0,1.9254000000059606
5,R_22YukpAa4vp3drL,42,f,1,1,1175,Remove Christopher Columbus statues,On campus concealed carry,1,-1,3,8,4,1.1293358837949117,0,2,2,-0.3710675046754708,3,-0,3,3,6,3,6,3,-3,3,0,1.175
5,R_22YukpAa4vp3drL,43,j,2,0,2432.9000000059605,Expel students with white nationlist views,Climate change legislation,1,1,2,8,3,0.6292014209714508,3,6,4,1.1293358837949117,2,3,1,1,-2,1,2,-1,1,-1,1,2.4329000000059606
5,R_22YukpAa4vp3drL,44,f,1,1,1493.7999999970198,U.S. drone strikes in Afghanistan,Remove Christopher Columbus statues,-1,-1,1,5,2,0.12906695814799,3,8,4,1.1293358837949117,-1,-3,2,-2,-3,2,3,2,-2,-2,0,1.4937999999970197
5,R_22YukpAa4vp3drL,45,j,2,0,1875,Affirmative action,Detention of migrant children,-1,-1,2,6,3,0.6292014209714508,-3,7,2,-1.8714708931458532,-2,3,5,-5,1,5,1,-5,5,5,1,1.875
5,R_22YukpAa4vp3drL,46,f,1,1,2100.2999999970198,Climate change legislation,Ban on ethnic Halloween costumes,1,1,3,6,4,1.1293358837949117,0,4,1,-0.3710675046754708,3,0,3,3,2,3,2,3,-3,3,0,2.1002999999970196
5,R_22YukpAa4vp3drL,47,j,2,0,5384.800000011921,Gun-free campus police,Climate change legislation,1,1,2,6,1,0.6292014209714508,3,6,4,1.1293358837949117,2,3,1,1,0,1,0,-1,1,-1,1,5.3848000000119205
5,R_22YukpAa4vp3drL,48,j,2,0,4858.0999999940395,Detention of migrant children,Climate change legislation,1,-1,-3,7,2,-1.8714708931458532,3,6,4,1.1293358837949117,-3,-3,0,6,-1,0,1,0,0,-6,1,4.85809999999404
5,R_22YukpAa4vp3drL,49,f,1,1,1623.2999999970198,Expel students with white nationlist views,Climate change legislation,1,-1,2,8,3,0.6292014209714508,3,6,4,1.1293358837949117,2,-3,5,-1,2,5,2,5,-5,-1,0,1.6232999999970197
5,R_22YukpAa4vp3drL,50,f,1,1,2233.5,Expel students with white nationlist views,War on Drugs,1,1,2,8,3,0.6292014209714508,-3,8,4,-1.8714708931458532,2,-3,5,5,0,5,0,5,-5,5,0,2.2335
5,R_22YukpAa4vp3drL,51,f,1,1,2383.4000000059605,Expel students with white nationlist views,Detention of migrant children,-1,1,2,8,3,0.6292014209714508,-3,7,2,-1.8714708931458532,-2,-3,1,5,1,1,1,1,-1,5,0,2.3834000000059605
5,R_22YukpAa4vp3drL,52,j,2,0,1559.4000000059605,Remove police from schools,Climate change legislation,1,1,2,7,3,0.6292014209714508,3,6,4,1.1293358837949117,2,3,1,1,-1,1,1,-1,1,-1,1,1.5594000000059605
5,R_22YukpAa4vp3drL,53,j,2,0,1861.4000000059605,Religious exemptions for discrimination laws,Climate change legislation,1,1,1,4,2,0.12906695814799,3,6,4,1.1293358837949117,1,3,2,2,2,2,2,-2,2,-2,1,1.8614000000059605
5,R_22YukpAa4vp3drL,54,j,2,0,1613.2999999970198,Climate change legislation,Detention of migrant children,-1,-1,3,6,4,1.1293358837949117,-3,7,2,-1.8714708931458532,-3,3,6,-6,1,6,1,-6,6,6,1,1.6132999999970197
5,R_22YukpAa4vp3drL,55,f,1,1,1755.5999999940395,Climate change legislation,Detention of migrant children,1,-1,3,6,4,1.1293358837949117,-3,7,2,-1.8714708931458532,3,3,0,6,-1,0,1,0,0,6,0,1.7555999999940395
5,R_22YukpAa4vp3drL,56,j,2,0,2136.5,Climate change legislation,Abolishing fraternities,-1,1,3,6,4,1.1293358837949117,0,5,3,-0.3710675046754708,-3,0,3,-3,-1,3,1,-3,3,3,1,2.1365
5,R_22YukpAa4vp3drL,57,j,2,0,2188.6000000089407,Religious exemptions for discrimination laws,Build southern border wall,-1,-1,1,4,2,0.12906695814799,-3,8,3,-1.8714708931458532,-1,3,4,-4,4,4,4,-4,4,4,1,2.1886000000089405
5,R_22YukpAa4vp3drL,58,f,1,1,2016.0999999940395,Climate change legislation,Mandatory training on sexual consent,1,1,3,6,4,1.1293358837949117,0,0,1,-0.3710675046754708,3,0,3,3,6,3,6,3,-3,3,0,2.0160999999940397
5,R_22YukpAa4vp3drL,59,j,2,0,2032.1000000089407,Detention of migrant children,Religious exemptions for discrimination laws,1,1,-3,7,2,-1.8714708931458532,1,4,2,0.12906695814799,-3,1,4,4,-3,4,3,-4,4,-4,1,2.0321000000089406
5,R_22YukpAa4vp3drL,60,j,2,0,1669.4000000059605,U.S. drone strikes in Afghanistan,Stop police brutality,-1,1,1,5,2,0.12906695814799,3,8,4,1.1293358837949117,-1,3,4,2,3,4,3,-4,4,-2,1,1.6694000000059606
5,R_22YukpAa4vp3drL,61,f,1,1,2063.7999999970198,Stop police brutality,Climate change legislation,1,1,3,8,4,1.1293358837949117,3,6,4,1.1293358837949117,3,3,0,0,2,0,2,0,0,0,0,2.06379999999702
5,R_22YukpAa4vp3drL,62,j,2,0,1565,Remove police from schools,Black Lives Matter,1,1,2,7,3,0.6292014209714508,3,8,4,1.1293358837949117,2,3,1,1,1,1,1,-1,1,-1,1,1.565
5,R_22YukpAa4vp3drL,63,j,2,0,1462.8999999910593,Detention of migrant children,Remove police from schools,-1,1,-3,7,2,-1.8714708931458532,2,7,3,0.6292014209714508,3,2,-1,5,0,1,0,1,-1,-5,1,1.4628999999910592
5,R_22YukpAa4vp3drL,64,f,1,1,996.7000000029802,Legalization of marijuana,Hardening schools/Arming teachers,1,1,3,8,4,1.1293358837949117,0,7,2,-0.3710675046754708,3,0,3,3,1,3,1,3,-3,3,0,0.9967000000029802
5,R_22YukpAa4vp3drL,65,j,2,0,2533.800000011921,Detention of migrant children,Climate change legislation,1,1,-3,7,2,-1.8714708931458532,3,6,4,1.1293358837949117,-3,3,6,6,-1,6,1,-6,6,-6,1,2.533800000011921
5,R_22YukpAa4vp3drL,66,j,2,0,1579.9000000059605,Detention of migrant children,Safe injection locations,1,1,-3,7,2,-1.8714708931458532,1,5,2,0.12906695814799,-3,1,4,4,-2,4,2,-4,4,-4,1,1.5799000000059604
5,R_22YukpAa4vp3drL,67,j,2,0,2513.9000000059605,Defund Planned Parenthood,Affirmative action,-1,1,-3,8,3,-1.8714708931458532,2,6,3,0.6292014209714508,3,2,-1,5,-2,1,2,1,-1,-5,1,2.5139000000059606
5,R_22YukpAa4vp3drL,68,j,2,0,1578.6000000089407,Detention of migrant children,Gun-free campus police,1,1,-3,7,2,-1.8714708931458532,2,6,1,0.6292014209714508,-3,2,5,5,-1,5,1,-5,5,-5,1,1.5786000000089406
5,R_22YukpAa4vp3drL,69,f,1,1,2153.5999999940395,Detention of migrant children,Legalization of marijuana,-1,-1,-3,7,2,-1.8714708931458532,3,8,4,1.1293358837949117,3,-3,6,-6,-1,6,1,6,-6,-6,0,2.1535999999940394
5,R_22YukpAa4vp3drL,70,f,1,1,1971.5,Remove police from schools,Legalization of marijuana,-1,-1,2,7,3,0.6292014209714508,3,8,4,1.1293358837949117,-2,-3,1,-1,-1,1,1,1,-1,-1,0,1.9715
5,R_22YukpAa4vp3drL,71,j,2,0,1569.2000000029802,On campus concealed carry,Climate change legislation,1,1,0,2,2,-0.3710675046754708,3,6,4,1.1293358837949117,0,3,3,3,4,3,4,-3,3,-3,1,1.5692000000029802
5,R_22YukpAa4vp3drL,72,j,2,0,1124.3999999910593,Mandatory trigger warnings,Climate change legislation,-1,1,1,5,2,0.12906695814799,3,6,4,1.1293358837949117,-1,3,4,2,1,4,1,-4,4,-2,1,1.1243999999910592
5,R_22YukpAa4vp3drL,73,j,2,0,1532.5,Religious exemptions for discrimination laws,Detention of migrant children,-1,-1,1,4,2,0.12906695814799,-3,7,2,-1.8714708931458532,-1,3,4,-4,3,4,3,-4,4,4,1,1.5325
5,R_22YukpAa4vp3drL,74,j,2,0,1549.3999999910593,Detention of migrant children,Gun-free campus police,-1,1,-3,7,2,-1.8714708931458532,2,6,1,0.6292014209714508,3,2,-1,5,-1,1,1,1,-1,-5,1,1.5493999999910593
5,R_22YukpAa4vp3drL,75,j,2,0,2285.2000000029802,Religious exemptions for discrimination laws,Detention of migrant children,1,-1,1,4,2,0.12906695814799,-3,7,2,-1.8714708931458532,1,3,2,-4,3,2,3,-2,2,4,1,2.2852000000029804
5,R_22YukpAa4vp3drL,76,j,2,0,2669.2999999970198,Climate change legislation,On campus concealed carry,-1,1,3,6,4,1.1293358837949117,0,2,2,-0.3710675046754708,-3,0,3,-3,-4,3,4,-3,3,3,1,2.66929999999702
5,R_22YukpAa4vp3drL,77,j,2,0,2617.5,Increased Gun regulations,Detention of migrant children,1,-1,1,5,2,0.12906695814799,-3,7,2,-1.8714708931458532,1,3,2,-4,2,2,2,-2,2,4,1,2.6175
5,R_22YukpAa4vp3drL,78,j,2,0,3839.7000000029802,War on Drugs,Detention of migrant children,1,1,-3,8,4,-1.8714708931458532,-3,7,2,-1.8714708931458532,-3,-3,0,0,-1,0,1,0,0,0,1,3.8397000000029804
5,R_22YukpAa4vp3drL,79,j,2,0,2606.6000000089407,Detention of migrant children,Remove police from schools,1,-1,-3,7,2,-1.8714708931458532,2,7,3,0.6292014209714508,-3,-2,1,5,0,1,0,-1,1,-5,1,2.6066000000089407
5,R_22YukpAa4vp3drL,80,f,1,1,2080.2999999970198,Abolishing private prisons,War on Drugs,1,1,2,7,3,0.6292014209714508,-3,8,4,-1.8714708931458532,2,-3,5,5,-1,5,1,5,-5,5,0,2.08029999999702
5,R_22YukpAa4vp3drL,81,j,2,0,1403.2999999970198,Detention of migrant children,Black Lives Matter,1,1,-3,7,2,-1.8714708931458532,3,8,4,1.1293358837949117,-3,3,6,6,1,6,1,-6,6,-6,1,1.4032999999970197
5,R_22YukpAa4vp3drL,82,j,2,0,2016.9000000059605,War on Drugs,Remove Christopher Columbus statues,1,1,-3,8,4,-1.8714708931458532,3,8,4,1.1293358837949117,-3,3,6,6,0,6,0,-6,6,-6,1,2.0169000000059603
5,R_22YukpAa4vp3drL,83,j,2,0,1826.5999999940395,Raise the minimum wage,Physician-assisted suicide,-1,-1,3,8,4,1.1293358837949117,0,7,4,-0.3710675046754708,-3,-0,3,-3,-1,3,1,-3,3,3,1,1.8265999999940394
5,R_22YukpAa4vp3drL,84,j,2,0,1648.4000000059605,Climate change legislation,Physician-assisted suicide,-1,-1,3,6,4,1.1293358837949117,0,7,4,-0.3710675046754708,-3,-0,3,-3,1,3,1,-3,3,3,1,1.6484000000059604
5,R_22YukpAa4vp3drL,85,j,2,0,2205.5999999940395,Detention of migrant children,Expel students with white nationlist views,1,1,-3,7,2,-1.8714708931458532,2,8,3,0.6292014209714508,-3,2,5,5,1,5,1,-5,5,-5,1,2.2055999999940394
5,R_22YukpAa4vp3drL,86,j,2,0,1999.2000000029802,Legalization of marijuana,Abolishing fraternities,-1,-1,3,8,4,1.1293358837949117,0,5,3,-0.3710675046754708,-3,-0,3,-3,-3,3,3,-3,3,3,1,1.9992000000029801
5,R_22YukpAa4vp3drL,87,f,1,1,2317.2999999970198,Mandatory training on sexual consent,Climate change legislation,-1,-1,0,0,1,-0.3710675046754708,3,6,4,1.1293358837949117,-0,-3,3,-3,-6,3,6,3,-3,-3,0,2.3172999999970196
5,R_22YukpAa4vp3drL,88,f,1,1,1396.0999999940395,Physician-assisted suicide,Detention of migrant children,-1,-1,0,7,4,-0.3710675046754708,-3,7,2,-1.8714708931458532,-0,3,-3,3,0,3,0,-3,3,3,0,1.3960999999940396
5,R_22YukpAa4vp3drL,89,f,1,1,1428.7000000029802,Climate change legislation,Abolishing fraternities,1,-1,3,6,4,1.1293358837949117,0,5,3,-0.3710675046754708,3,-0,3,3,1,3,1,3,-3,3,0,1.4287000000029801
5,R_22YukpAa4vp3drL,90,j,2,0,1629.2999999970198,Climate change legislation,Mandatory trigger warnings,-1,-1,3,6,4,1.1293358837949117,1,5,2,0.12906695814799,-3,-1,2,-2,-1,2,1,-2,2,2,1,1.6292999999970197
5,R_22YukpAa4vp3drL,91,j,2,0,1387.2999999970198,Legalization of marijuana,Religious exemptions for discrimination laws,-1,-1,3,8,4,1.1293358837949117,1,4,2,0.12906695814799,-3,-1,2,-2,-4,2,4,-2,2,2,1,1.3872999999970197
5,R_22YukpAa4vp3drL,92,j,2,0,2540.2999999970198,Climate change legislation,Abolishing private prisons,-1,-1,3,6,4,1.1293358837949117,2,7,3,0.6292014209714508,-3,-2,1,-1,1,1,1,-1,1,1,1,2.54029999999702
5,R_22YukpAa4vp3drL,93,j,2,0,1372.5,Legalization of marijuana,On campus concealed carry,-1,-1,3,8,4,1.1293358837949117,0,2,2,-0.3710675046754708,-3,-0,3,-3,-6,3,6,-3,3,3,1,1.3725
5,R_22YukpAa4vp3drL,94,f,1,1,3628.5,Cuts to National Parks budget,Gun-free campus police,-1,-1,-3,8,3,-1.8714708931458532,2,6,1,0.6292014209714508,3,-2,5,-5,2,5,2,5,-5,-5,0,3.6285
5,R_22YukpAa4vp3drL,95,f,1,1,1769.7999999970198,Black Lives Matter,Abolishing private prisons,1,-1,3,8,4,1.1293358837949117,2,7,3,0.6292014209714508,3,-2,5,1,1,5,1,5,-5,1,0,1.7697999999970198
5,R_22YukpAa4vp3drL,96,j,2,0,2913.5999999940395,Raise the minimum wage,"Boycott, Divest, and Sanction Israel",-1,1,3,8,4,1.1293358837949117,0,0,1,-0.3710675046754708,-3,0,3,-3,-8,3,8,-3,3,3,1,2.9135999999940396
5,R_22YukpAa4vp3drL,97,j,2,0,1421.9000000059605,Detention of migrant children,U.S. drone strikes in Afghanistan,-1,-1,-3,7,2,-1.8714708931458532,1,5,2,0.12906695814799,3,-1,-4,4,-2,4,2,4,-4,-4,1,1.4219000000059605
5,R_22YukpAa4vp3drL,98,f,1,1,1817.2000000029802,Climate change legislation,Build southern border wall,1,1,3,6,4,1.1293358837949117,-3,8,3,-1.8714708931458532,3,-3,6,6,-2,6,2,6,-6,6,0,1.8172000000029802
5,R_22YukpAa4vp3drL,99,j,2,0,1879.2999999970198,Raise the minimum wage,Safe injection locations,-1,1,3,8,4,1.1293358837949117,1,5,2,0.12906695814799,-3,1,4,-2,-3,4,3,-4,4,2,1,1.8792999999970197
5,R_22YukpAa4vp3drL,100,j,2,0,1733.7999999970198,Expel students with white nationlist views,Detention of migrant children,1,-1,2,8,3,0.6292014209714508,-3,7,2,-1.8714708931458532,2,3,1,-5,-1,1,1,-1,1,5,1,1.7337999999970197
14,R_6rmmVOUTc01qvpD,1,f,1,1,1947.2000000178814,"Boycott, Divest, and Sanction Israel",Recognize Jerusalem as capital of Israel,-1,1,2,8,3,0.5533403717516997,-2,0,3,-0.9222339529194996,-2,-2,0,4,8,0,8,0,0,4,0,1.9472000000178813
14,R_6rmmVOUTc01qvpD,2,j,2,0,2363.5999999940395,Mandatory vaccinations,Physician-assisted suicide,1,-1,2,6,3,0.5533403717516997,2,8,4,0.5533403717516997,2,-2,-4,0,2,4,2,4,-4,0,1,2.3635999999940394
14,R_6rmmVOUTc01qvpD,3,j,2,0,5698.9000000059605,Mandatory vaccinations,Mandatory vaccinations,-1,1,2,6,3,0.5533403717516997,2,6,3,0.5533403717516997,-2,2,4,0,0,4,0,-4,4,0,1,5.698900000005961
14,R_6rmmVOUTc01qvpD,4,j,2,0,3784,Mask mandates,Mandatory vaccinations,-1,1,3,8,4,0.9222339529194996,2,6,3,0.5533403717516997,-3,2,5,-1,-2,5,2,-5,5,1,1,3.784
14,R_6rmmVOUTc01qvpD,5,f,1,1,3041.5,Cuts to National Parks budget,Recognize Jerusalem as capital of Israel,-1,1,-3,8,3,-1.2911275340872994,-2,0,3,-0.9222339529194996,3,-2,5,-1,8,5,8,5,-5,-1,0,3.0415
14,R_6rmmVOUTc01qvpD,6,f,1,1,4651.4000000059605,Mandatory vaccinations,Mandatory trigger warnings,1,1,2,6,3,0.5533403717516997,1,1,1,0.18444679058389993,2,1,1,1,5,1,5,1,-1,1,0,4.65140000000596
14,R_6rmmVOUTc01qvpD,7,f,1,1,2779.5,Mandatory trigger warnings,Physician-assisted suicide,1,-1,1,1,1,0.18444679058389993,2,8,4,0.5533403717516997,1,-2,3,-1,-7,3,7,3,-3,-1,0,2.7795
14,R_6rmmVOUTc01qvpD,8,j,2,0,2704.7999999821186,Lift COVID lockdowns,Physician-assisted suicide,1,1,-3,8,4,-1.2911275340872994,2,8,4,0.5533403717516997,-3,2,5,5,0,5,0,-5,5,-5,1,2.7047999999821184
14,R_6rmmVOUTc01qvpD,9,j,2,0,3566.2999999821186,Ban on research with animals,Mandatory drug tests for welfare recipients,1,-1,0,0,2,-0.18444679058389993,-3,8,4,-1.2911275340872994,0,3,3,-3,8,3,8,-3,3,3,1,3.5662999999821188
14,R_6rmmVOUTc01qvpD,10,f,1,1,3837.100000023842,Mandatory vaccinations,Physician-assisted suicide,-1,-1,2,6,3,0.5533403717516997,2,8,4,0.5533403717516997,-2,-2,0,0,-2,0,2,0,0,0,0,3.8371000000238418
14,R_6rmmVOUTc01qvpD,11,f,1,1,2489.399999976158,"Boycott, Divest, and Sanction Israel","Boycott, Divest, and Sanction Israel",1,-1,2,8,3,0.5533403717516997,2,8,3,0.5533403717516997,2,-2,4,0,0,4,0,4,-4,0,0,2.489399999976158
14,R_6rmmVOUTc01qvpD,12,j,2,0,3271.5,Mandatory trigger warnings,On campus concealed carry,-1,1,1,1,1,0.18444679058389993,0,0,1,-0.18444679058389993,-1,0,1,-1,-1,1,1,-1,1,1,1,3.2715
14,R_6rmmVOUTc01qvpD,13,f,1,1,5512.799999982119,Ban on research with animals,Legalization of marijuana,1,-1,0,0,2,-0.18444679058389993,3,8,4,0.9222339529194996,0,-3,3,-3,-8,3,8,3,-3,-3,0,5.512799999982119
14,R_6rmmVOUTc01qvpD,14,j,2,0,6495.800000011921,Abolishing private prisons,Mandatory vaccinations,-1,-1,3,8,4,0.9222339529194996,2,6,3,0.5533403717516997,-3,-2,1,-1,-2,1,2,-1,1,1,1,6.495800000011921
14,R_6rmmVOUTc01qvpD,15,j,2,0,8049.5,Gun-free campus police,Mandatory trigger warnings,-1,-1,3,8,4,0.9222339529194996,1,1,1,0.18444679058389993,-3,-1,2,-2,-7,2,7,-2,2,2,1,8.0495
14,R_6rmmVOUTc01qvpD,16,j,2,0,3498.0999999940395,Physician-assisted suicide,Recognize Jerusalem as capital of Israel,-1,-1,2,8,4,0.5533403717516997,-2,0,3,-0.9222339529194996,-2,2,4,-4,-8,4,8,-4,4,4,1,3.4980999999940394
14,R_6rmmVOUTc01qvpD,17,j,2,0,2646.800000011921,Recognize Jerusalem as capital of Israel,Mandatory vaccinations,1,-1,-2,0,3,-0.9222339529194996,2,6,3,0.5533403717516997,-2,-2,0,4,6,0,6,0,0,-4,1,2.646800000011921
14,R_6rmmVOUTc01qvpD,18,j,2,0,4082.899999976158,Mandatory vaccinations,Cuts to National Parks budget,1,-1,2,6,3,0.5533403717516997,-3,8,3,-1.2911275340872994,2,3,1,-5,2,1,2,-1,1,5,1,4.082899999976158
14,R_6rmmVOUTc01qvpD,19,j,2,0,3547.199999988079,"Boycott, Divest, and Sanction Israel",Defund Planned Parenthood,1,-1,2,8,3,0.5533403717516997,-3,8,4,-1.2911275340872994,2,3,1,-5,0,1,0,-1,1,5,1,3.547199999988079
14,R_6rmmVOUTc01qvpD,20,j,2,0,4963.699999988079,Mandatory trigger warnings,Mandatory vaccinations,1,1,1,1,1,0.18444679058389993,2,6,3,0.5533403717516997,1,2,1,1,5,1,5,-1,1,-1,1,4.963699999988079
14,R_6rmmVOUTc01qvpD,21,j,2,0,7830.5999999940395,Recognize Jerusalem as capital of Israel,Recognize Jerusalem as capital of Israel,1,-1,-2,0,3,-0.9222339529194996,-2,0,3,-0.9222339529194996,-2,2,4,0,0,4,0,-4,4,0,1,7.83059999999404
14,R_6rmmVOUTc01qvpD,22,j,2,0,3708.0999999940395,Mandatory trigger warnings,Mandatory vaccinations,-1,-1,1,1,1,0.18444679058389993,2,6,3,0.5533403717516997,-1,-2,-1,1,5,1,5,1,-1,-1,1,3.7080999999940394
14,R_6rmmVOUTc01qvpD,23,j,2,0,4271.200000017881,Mandatory vaccinations,Recognize Jerusalem as capital of Israel,-1,-1,2,6,3,0.5533403717516997,-2,0,3,-0.9222339529194996,-2,2,4,-4,-6,4,6,-4,4,4,1,4.271200000017881
14,R_6rmmVOUTc01qvpD,24,f,1,1,4363.0999999940395,Physician-assisted suicide,Cuts to National Parks budget,1,1,2,8,4,0.5533403717516997,-3,8,3,-1.2911275340872994,2,-3,5,5,0,5,0,5,-5,5,0,4.36309999999404
14,R_6rmmVOUTc01qvpD,25,j,2,0,2392.399999976158,Mandatory trigger warnings,Expel students with white nationlist views,-1,1,1,1,1,0.18444679058389993,3,8,3,0.9222339529194996,-1,3,4,2,7,4,7,-4,4,-2,1,2.392399999976158
14,R_6rmmVOUTc01qvpD,26,j,2,0,2297.300000011921,Mandatory vaccinations,"Boycott, Divest, and Sanction Israel",-1,1,2,6,3,0.5533403717516997,2,8,3,0.5533403717516997,-2,2,4,0,2,4,2,-4,4,0,1,2.297300000011921
14,R_6rmmVOUTc01qvpD,27,j,2,0,2125.199999988079,Recognize Jerusalem as capital of Israel,Mandatory vaccinations,1,-1,-2,0,3,-0.9222339529194996,2,6,3,0.5533403717516997,-2,-2,0,4,6,0,6,0,0,-4,1,2.1251999999880793
14,R_6rmmVOUTc01qvpD,28,j,2,0,4008.5999999940395,"Boycott, Divest, and Sanction Israel",Defund the police,-1,1,2,8,3,0.5533403717516997,3,8,4,0.9222339529194996,-2,3,5,1,0,5,0,-5,5,-1,1,4.00859999999404
14,R_6rmmVOUTc01qvpD,29,f,1,1,4225.5,Abolishing fraternities,Recognize Jerusalem as capital of Israel,1,-1,3,8,3,0.9222339529194996,-2,0,3,-0.9222339529194996,3,2,1,5,8,1,8,1,-1,5,0,4.2255
14,R_6rmmVOUTc01qvpD,30,j,2,0,1953.2999999821186,Mandatory trigger warnings,Mandatory vaccinations,1,-1,1,1,1,0.18444679058389993,2,6,3,0.5533403717516997,1,-2,-3,1,5,3,5,3,-3,-1,1,1.9532999999821186
14,R_6rmmVOUTc01qvpD,31,j,2,0,6389.4000000059605,Physician-assisted suicide,"Boycott, Divest, and Sanction Israel",1,-1,2,8,4,0.5533403717516997,2,8,3,0.5533403717516997,2,-2,-4,0,0,4,0,4,-4,0,1,6.389400000005961
14,R_6rmmVOUTc01qvpD,32,j,2,0,3466.5,Mandatory trigger warnings,"Boycott, Divest, and Sanction Israel",1,1,1,1,1,0.18444679058389993,2,8,3,0.5533403717516997,1,2,1,1,7,1,7,-1,1,-1,1,3.4665
14,R_6rmmVOUTc01qvpD,33,f,1,1,2706.899999976158,Mandatory trigger warnings,Recognize Jerusalem as capital of Israel,-1,1,1,1,1,0.18444679058389993,-2,0,3,-0.9222339529194996,-1,-2,1,3,1,1,1,1,-1,3,0,2.7068999999761583
14,R_6rmmVOUTc01qvpD,34,j,2,0,3183.7000000178814,"Boycott, Divest, and Sanction Israel",Mandatory trigger warnings,-1,-1,2,8,3,0.5533403717516997,1,1,1,0.18444679058389993,-2,-1,1,-1,-7,1,7,-1,1,1,1,3.1837000000178812
14,R_6rmmVOUTc01qvpD,35,j,2,0,2790.199999988079,Recognize Jerusalem as capital of Israel,Physician-assisted suicide,1,1,-2,0,3,-0.9222339529194996,2,8,4,0.5533403717516997,-2,2,4,4,8,4,8,-4,4,-4,1,2.790199999988079
14,R_6rmmVOUTc01qvpD,36,j,2,0,2190,Mandatory trigger warnings,Mandatory vaccinations,-1,1,1,1,1,0.18444679058389993,2,6,3,0.5533403717516997,-1,2,3,1,5,3,5,-3,3,-1,1,2.19
14,R_6rmmVOUTc01qvpD,37,f,1,1,1867.7000000178814,Affirmative action,Mandatory vaccinations,1,1,3,8,4,0.9222339529194996,2,6,3,0.5533403717516997,3,2,1,1,2,1,2,1,-1,1,0,1.8677000000178814
14,R_6rmmVOUTc01qvpD,38,f,1,1,2443.5999999940395,Mandatory trigger warnings,Physician-assisted suicide,-1,-1,1,1,1,0.18444679058389993,2,8,4,0.5533403717516997,-1,-2,1,-1,-7,1,7,1,-1,-1,0,2.4435999999940394
14,R_6rmmVOUTc01qvpD,39,f,1,1,2983.199999988079,Recognize Jerusalem as capital of Israel,Mandatory vaccinations,-1,1,-2,0,3,-0.9222339529194996,2,6,3,0.5533403717516997,2,2,0,-4,-6,0,6,0,0,-4,0,2.983199999988079
14,R_6rmmVOUTc01qvpD,40,f,1,1,2998.4000000059605,Mandatory trigger warnings,Mandatory trigger warnings,1,-1,1,1,1,0.18444679058389993,1,1,1,0.18444679058389993,1,-1,2,0,0,2,0,2,-2,0,0,2.9984000000059603
14,R_6rmmVOUTc01qvpD,41,j,2,0,2949.5,Mandatory trigger warnings,Gun-free campus police,-1,-1,1,1,1,0.18444679058389993,3,8,4,0.9222339529194996,-1,-3,-2,2,7,2,7,2,-2,-2,1,2.9495
14,R_6rmmVOUTc01qvpD,42,j,2,0,1633.4000000059605,Recognize Jerusalem as capital of Israel,Mandatory vaccinations,1,1,-2,0,3,-0.9222339529194996,2,6,3,0.5533403717516997,-2,2,4,4,6,4,6,-4,4,-4,1,1.6334000000059605
14,R_6rmmVOUTc01qvpD,43,f,1,1,4230.100000023842,Mandatory vaccinations,Ban on research with animals,1,-1,2,6,3,0.5533403717516997,0,0,2,-0.18444679058389993,2,-0,2,2,6,2,6,2,-2,2,0,4.230100000023842
14,R_6rmmVOUTc01qvpD,44,j,2,0,6209.199999988079,Climate change legislation,Ban on research with animals,-1,1,3,8,3,0.9222339529194996,0,0,2,-0.18444679058389993,-3,0,3,-3,-8,3,8,-3,3,3,1,6.209199999988079
14,R_6rmmVOUTc01qvpD,45,j,2,0,3475.300000011921,Recognize Jerusalem as capital of Israel,Mandatory vaccinations,1,1,-2,0,3,-0.9222339529194996,2,6,3,0.5533403717516997,-2,2,4,4,6,4,6,-4,4,-4,1,3.475300000011921
14,R_6rmmVOUTc01qvpD,46,j,2,0,2918.2999999821186,"Boycott, Divest, and Sanction Israel",Increased Gun regulations,-1,1,2,8,3,0.5533403717516997,0,0,2,-0.18444679058389993,-2,0,2,-2,-8,2,8,-2,2,2,1,2.9182999999821186
14,R_6rmmVOUTc01qvpD,47,f,1,1,3562.7000000178814,Religious exemptions for discrimination laws,Mandatory trigger warnings,-1,-1,-3,8,3,-1.2911275340872994,1,1,1,0.18444679058389993,3,-1,4,-4,7,4,7,4,-4,-4,0,3.5627000000178812
14,R_6rmmVOUTc01qvpD,48,f,1,1,4411.700000017881,Recognize Jerusalem as capital of Israel,Mandatory vaccinations,-1,1,-2,0,3,-0.9222339529194996,2,6,3,0.5533403717516997,2,2,0,-4,-6,0,6,0,0,-4,0,4.411700000017881
14,R_6rmmVOUTc01qvpD,49,j,2,0,3375.5,Recognize Jerusalem as capital of Israel,Ban on research with animals,1,1,-2,0,3,-0.9222339529194996,0,0,2,-0.18444679058389993,-2,0,2,2,0,2,0,-2,2,-2,1,3.3755
14,R_6rmmVOUTc01qvpD,50,f,1,1,4552.4000000059605,"Boycott, Divest, and Sanction Israel",Mandatory vaccinations,1,-1,2,8,3,0.5533403717516997,2,6,3,0.5533403717516997,2,-2,4,0,2,4,2,4,-4,0,0,4.55240000000596
14,R_6rmmVOUTc01qvpD,51,f,1,1,2346.4000000059605,Mandatory trigger warnings,Mandatory vaccinations,1,-1,1,1,1,0.18444679058389993,2,6,3,0.5533403717516997,1,-2,3,-1,-5,3,5,3,-3,-1,0,2.3464000000059606
14,R_6rmmVOUTc01qvpD,52,j,2,0,2783.399999976158,Mandatory vaccinations,"Boycott, Divest, and Sanction Israel",1,1,2,6,3,0.5533403717516997,2,8,3,0.5533403717516997,2,2,0,0,2,0,2,0,0,0,1,2.783399999976158
14,R_6rmmVOUTc01qvpD,53,f,1,1,4695.799999982119,Bathrooms restricted based on biological sex,Recognize Jerusalem as capital of Israel,-1,1,-3,8,4,-1.2911275340872994,-2,0,3,-0.9222339529194996,3,-2,5,-1,8,5,8,5,-5,-1,0,4.6957999999821185
14,R_6rmmVOUTc01qvpD,54,j,2,0,2952.5,On campus concealed carry,Mandatory vaccinations,1,-1,0,0,1,-0.18444679058389993,2,6,3,0.5533403717516997,0,-2,-2,2,6,2,6,2,-2,-2,1,2.9525
14,R_6rmmVOUTc01qvpD,55,f,1,1,4781.4000000059605,"Boycott, Divest, and Sanction Israel",Abolishing private prisons,-1,-1,2,8,3,0.5533403717516997,3,8,4,0.9222339529194996,-2,-3,1,-1,0,1,0,1,-1,-1,0,4.78140000000596
14,R_6rmmVOUTc01qvpD,56,f,1,1,5358.799999982119,Mandatory vaccinations,Mandatory trigger warnings,1,-1,2,6,3,0.5533403717516997,1,1,1,0.18444679058389993,2,-1,3,1,5,3,5,3,-3,1,0,5.358799999982119
14,R_6rmmVOUTc01qvpD,57,j,2,0,4737.4000000059605,Recognize Jerusalem as capital of Israel,Physician-assisted suicide,-1,1,-2,0,3,-0.9222339529194996,2,8,4,0.5533403717516997,2,2,0,4,8,0,8,0,0,-4,1,4.737400000005961
14,R_6rmmVOUTc01qvpD,58,f,1,1,5137.9000000059605,Recognize Jerusalem as capital of Israel,Abolishing fraternities,-1,-1,-2,0,3,-0.9222339529194996,3,8,3,0.9222339529194996,2,-3,5,-5,-8,5,8,5,-5,-5,0,5.137900000005961
14,R_6rmmVOUTc01qvpD,59,j,2,0,1910.800000011921,Mandatory trigger warnings,Ban on research with animals,1,1,1,1,1,0.18444679058389993,0,0,2,-0.18444679058389993,1,0,-1,-1,-1,1,1,1,-1,1,1,1.910800000011921
14,R_6rmmVOUTc01qvpD,60,j,2,0,3209.699999988079,Stop police brutality,Recognize Jerusalem as capital of Israel,-1,-1,3,8,4,0.9222339529194996,-2,0,3,-0.9222339529194996,-3,2,5,-5,-8,5,8,-5,5,5,1,3.209699999988079
14,R_6rmmVOUTc01qvpD,61,f,1,1,4148.5999999940395,Mandatory vaccinations,Physician-assisted suicide,1,-1,2,6,3,0.5533403717516997,2,8,4,0.5533403717516997,2,-2,4,0,-2,4,2,4,-4,0,0,4.1485999999940395
14,R_6rmmVOUTc01qvpD,62,f,1,1,3440.399999976158,Mandatory drug tests for welfare recipients,Physician-assisted suicide,-1,1,-3,8,4,-1.2911275340872994,2,8,4,0.5533403717516997,3,2,1,-5,0,1,0,1,-1,-5,0,3.440399999976158
14,R_6rmmVOUTc01qvpD,63,j,2,0,2641,Recognize Jerusalem as capital of Israel,Defund Planned Parenthood,-1,-1,-2,0,3,-0.9222339529194996,-3,8,4,-1.2911275340872994,2,3,1,-1,8,1,8,-1,1,1,1,2.641
14,R_6rmmVOUTc01qvpD,64,j,2,0,8108.800000011921,Student worker unionization,Recognize Jerusalem as capital of Israel,-1,1,3,8,4,0.9222339529194996,-2,0,3,-0.9222339529194996,-3,-2,1,-5,-8,1,8,-1,1,5,1,8.108800000011922
14,R_6rmmVOUTc01qvpD,65,f,1,1,4598.800000011921,Mandatory trigger warnings,Student worker unionization,1,-1,1,1,1,0.18444679058389993,3,8,4,0.9222339529194996,1,-3,4,-2,-7,4,7,4,-4,-2,0,4.598800000011921
14,R_6rmmVOUTc01qvpD,66,f,1,1,2424.9000000059605,Mandatory trigger warnings,Recognize Jerusalem as capital of Israel,1,1,1,1,1,0.18444679058389993,-2,0,3,-0.9222339529194996,1,-2,3,3,1,3,1,3,-3,3,0,2.4249000000059606
14,R_6rmmVOUTc01qvpD,67,j,2,0,10378.800000011921,Legalization of marijuana,Recognize Jerusalem as capital of Israel,-1,1,3,8,4,0.9222339529194996,-2,0,3,-0.9222339529194996,-3,-2,1,-5,-8,1,8,-1,1,5,1,10.378800000011921
14,R_6rmmVOUTc01qvpD,68,f,1,1,2751.9000000059605,Recognize Jerusalem as capital of Israel,Increased Gun regulations,-1,-1,-2,0,3,-0.9222339529194996,0,0,2,-0.18444679058389993,2,-0,2,-2,0,2,0,2,-2,-2,0,2.7519000000059606
14,R_6rmmVOUTc01qvpD,69,j,2,0,4409,Mandatory trigger warnings,Religious exemptions for discrimination laws,1,-1,1,1,1,0.18444679058389993,-3,8,3,-1.2911275340872994,1,3,2,-4,7,2,7,-2,2,4,1,4.409
14,R_6rmmVOUTc01qvpD,70,j,2,0,5052.799999982119,Physician-assisted suicide,Recognize Jerusalem as capital of Israel,-1,1,2,8,4,0.5533403717516997,-2,0,3,-0.9222339529194996,-2,-2,0,-4,-8,0,8,0,0,4,1,5.052799999982119
14,R_6rmmVOUTc01qvpD,71,f,1,1,5605.899999976158,Mandatory vaccinations,Mandatory trigger warnings,-1,-1,2,6,3,0.5533403717516997,1,1,1,0.18444679058389993,-2,-1,-1,1,5,1,5,-1,1,1,0,5.605899999976158
14,R_6rmmVOUTc01qvpD,72,j,2,0,2501.800000011921,On campus concealed carry,Physician-assisted suicide,1,1,0,0,1,-0.18444679058389993,2,8,4,0.5533403717516997,0,2,2,2,8,2,8,-2,2,-2,1,2.501800000011921
14,R_6rmmVOUTc01qvpD,73,j,2,0,3629.5999999940395,Mandatory vaccinations,Mandatory drug tests for welfare recipients,-1,-1,2,6,3,0.5533403717516997,-3,8,4,-1.2911275340872994,-2,3,5,-5,2,5,2,-5,5,5,1,3.6295999999940394
14,R_6rmmVOUTc01qvpD,74,f,1,1,3014.199999988079,Climate change legislation,Mandatory trigger warnings,1,1,3,8,3,0.9222339529194996,1,1,1,0.18444679058389993,3,1,2,2,7,2,7,2,-2,2,0,3.014199999988079
14,R_6rmmVOUTc01qvpD,75,f,1,1,2530.5999999940395,Recognize Jerusalem as capital of Israel,Mandatory vaccinations,-1,-1,-2,0,3,-0.9222339529194996,2,6,3,0.5533403717516997,2,-2,4,-4,-6,4,6,4,-4,-4,0,2.5305999999940396
14,R_6rmmVOUTc01qvpD,76,f,1,1,2375,"Boycott, Divest, and Sanction Israel",Ban on research with animals,1,1,2,8,3,0.5533403717516997,0,0,2,-0.18444679058389993,2,0,2,2,8,2,8,2,-2,2,0,2.375
14,R_6rmmVOUTc01qvpD,77,f,1,1,2390.5,Abolishing fraternities,Mandatory vaccinations,-1,-1,3,8,3,0.9222339529194996,2,6,3,0.5533403717516997,-3,-2,-1,1,2,1,2,-1,1,1,0,2.3905
14,R_6rmmVOUTc01qvpD,78,f,1,1,3270.600000023842,Physician-assisted suicide,Recognize Jerusalem as capital of Israel,1,-1,2,8,4,0.5533403717516997,-2,0,3,-0.9222339529194996,2,2,0,4,8,0,8,0,0,4,0,3.2706000000238418
14,R_6rmmVOUTc01qvpD,79,f,1,1,2910.0999999940395,Detention of migrant children,Detention of migrant children,-1,1,-3,8,4,-1.2911275340872994,-3,8,4,-1.2911275340872994,3,-3,6,0,0,6,0,6,-6,0,0,2.9100999999940393
14,R_6rmmVOUTc01qvpD,80,j,2,0,2060.199999988079,Mask mandates,Mandatory trigger warnings,-1,1,3,8,4,0.9222339529194996,1,1,1,0.18444679058389993,-3,1,4,-2,-7,4,7,-4,4,2,1,2.060199999988079
14,R_6rmmVOUTc01qvpD,81,f,1,1,1895.199999988079,Climate change legislation,Mandatory vaccinations,1,-1,3,8,3,0.9222339529194996,2,6,3,0.5533403717516997,3,-2,5,1,2,5,2,5,-5,1,0,1.895199999988079
14,R_6rmmVOUTc01qvpD,82,f,1,1,2893.800000011921,Mandatory vaccinations,Cuts to National Parks budget,1,1,2,6,3,0.5533403717516997,-3,8,3,-1.2911275340872994,2,-3,5,5,-2,5,2,5,-5,5,0,2.893800000011921
14,R_6rmmVOUTc01qvpD,83,j,2,0,2647,U.S. drone strikes in Afghanistan,Religious exemptions for discrimination laws,1,-1,-3,8,3,-1.2911275340872994,-3,8,3,-1.2911275340872994,-3,3,6,0,0,6,0,-6,6,0,1,2.647
14,R_6rmmVOUTc01qvpD,84,j,2,0,4185.0999999940395,Mandatory vaccinations,Mandatory vaccinations,-1,1,2,6,3,0.5533403717516997,2,6,3,0.5533403717516997,-2,2,4,0,0,4,0,-4,4,0,1,4.18509999999404
14,R_6rmmVOUTc01qvpD,85,f,1,1,4086.600000023842,Mandatory vaccinations,On campus concealed carry,1,-1,2,6,3,0.5533403717516997,0,0,1,-0.18444679058389993,2,-0,2,2,6,2,6,2,-2,2,0,4.086600000023842
14,R_6rmmVOUTc01qvpD,86,j,2,0,3448.0999999940395,Mask mandates,Increased Gun regulations,1,-1,3,8,4,0.9222339529194996,0,0,2,-0.18444679058389993,3,-0,-3,-3,-8,3,8,3,-3,3,1,3.4480999999940396
14,R_6rmmVOUTc01qvpD,87,f,1,1,1855.9000000059605,Physician-assisted suicide,Mandatory vaccinations,1,1,2,8,4,0.5533403717516997,2,6,3,0.5533403717516997,2,2,0,0,2,0,2,0,0,0,0,1.8559000000059604
14,R_6rmmVOUTc01qvpD,88,j,2,0,3015.199999988079,"Boycott, Divest, and Sanction Israel",Recognize Jerusalem as capital of Israel,-1,-1,2,8,3,0.5533403717516997,-2,0,3,-0.9222339529194996,-2,2,4,-4,-8,4,8,-4,4,4,1,3.015199999988079
14,R_6rmmVOUTc01qvpD,89,f,1,1,4649.5,Mandatory vaccinations,"Boycott, Divest, and Sanction Israel",-1,-1,2,6,3,0.5533403717516997,2,8,3,0.5533403717516997,-2,-2,0,0,-2,0,2,0,0,0,0,4.6495
14,R_6rmmVOUTc01qvpD,90,j,2,0,1810.5,Mandatory trigger warnings,Physician-assisted suicide,-1,1,1,1,1,0.18444679058389993,2,8,4,0.5533403717516997,-1,2,3,1,7,3,7,-3,3,-1,1,1.8105
14,R_6rmmVOUTc01qvpD,91,j,2,0,2884.5,Mandatory trigger warnings,"Boycott, Divest, and Sanction Israel",-1,1,1,1,1,0.18444679058389993,2,8,3,0.5533403717516997,-1,2,3,1,7,3,7,-3,3,-1,1,2.8845
14,R_6rmmVOUTc01qvpD,92,f,1,1,3791.699999988079,Mask mandates,Physician-assisted suicide,1,-1,3,8,4,0.9222339529194996,2,8,4,0.5533403717516997,3,-2,5,1,0,5,0,5,-5,1,0,3.791699999988079
14,R_6rmmVOUTc01qvpD,93,j,2,0,5281.4000000059605,Raise the minimum wage,Physician-assisted suicide,-1,-1,3,8,4,0.9222339529194996,2,8,4,0.5533403717516997,-3,-2,1,-1,0,1,0,-1,1,1,1,5.28140000000596
14,R_6rmmVOUTc01qvpD,94,j,2,0,3582.300000011921,Mandatory trigger warnings,Physician-assisted suicide,1,1,1,1,1,0.18444679058389993,2,8,4,0.5533403717516997,1,2,1,1,7,1,7,-1,1,-1,1,3.5823000000119207
14,R_6rmmVOUTc01qvpD,95,f,1,1,2017.7999999821186,"Boycott, Divest, and Sanction Israel",Recognize Jerusalem as capital of Israel,1,1,2,8,3,0.5533403717516997,-2,0,3,-0.9222339529194996,2,-2,4,4,8,4,8,4,-4,4,0,2.0177999999821186
14,R_6rmmVOUTc01qvpD,96,f,1,1,4785.199999988079,Recognize Jerusalem as capital of Israel,Mandatory trigger warnings,-1,1,-2,0,3,-0.9222339529194996,1,1,1,0.18444679058389993,2,1,1,-3,-1,1,1,1,-1,-3,0,4.785199999988079
14,R_6rmmVOUTc01qvpD,97,j,2,0,4536.9000000059605,Mandatory vaccinations,On campus concealed carry,-1,1,2,6,3,0.5533403717516997,0,0,1,-0.18444679058389993,-2,0,2,-2,-6,2,6,-2,2,2,1,4.536900000005961
14,R_6rmmVOUTc01qvpD,98,f,1,1,2531.100000023842,Recognize Jerusalem as capital of Israel,Mandatory trigger warnings,-1,-1,-2,0,3,-0.9222339529194996,1,1,1,0.18444679058389993,2,-1,3,-3,-1,3,1,3,-3,-3,0,2.5311000000238417
14,R_6rmmVOUTc01qvpD,99,j,2,0,2409.600000023842,Physician-assisted suicide,Mandatory trigger warnings,-1,1,2,8,4,0.5533403717516997,1,1,1,0.18444679058389993,-2,1,3,-1,-7,3,7,-3,3,1,1,2.409600000023842
14,R_6rmmVOUTc01qvpD,100,f,1,1,3444.800000011921,On campus concealed carry,"Boycott, Divest, and Sanction Israel",-1,-1,0,0,1,-0.18444679058389993,2,8,3,0.5533403717516997,-0,-2,2,-2,-8,2,8,2,-2,-2,0,3.444800000011921
3,R_1lrWlqblZ3mTGMR,1,f,1,1,9723.899999976158,Lift COVID lockdowns,Black Lives Matter,1,-1,-1,7,2,-0.9722280223008438,3,7,4,1.4957354189243752,-1,-3,2,-4,0,2,0,2,-2,-4,0,9.723899999976158
3,R_1lrWlqblZ3mTGMR,2,j,2,0,918.8000000715256,Affirmative action,Safe injection locations,-1,-1,0,3,3,-0.35523716199453903,3,7,4,1.4957354189243752,-0,-3,-3,3,4,3,4,3,-3,-3,1,0.9188000000715256
3,R_1lrWlqblZ3mTGMR,4,f,1,1,9399.900000095367,Safe injection locations,University Campus should be a Sanctuary,1,1,3,7,4,1.4957354189243752,-1,5,3,-0.9722280223008438,3,-1,4,4,2,4,2,4,-4,4,0,9.399900000095368
3,R_1lrWlqblZ3mTGMR,5,j,2,0,8303.700000047684,U.S. drone strikes in Afghanistan,Religious exemptions for discrimination laws,-1,-1,3,5,4,1.4957354189243752,-3,5,2,-2.2062097429134533,-3,3,6,-6,0,6,0,-6,6,6,1,8.303700000047684
3,R_1lrWlqblZ3mTGMR,6,f,1,1,4516,Safe injection locations,U.S. drone strikes in Afghanistan,1,-1,3,7,4,1.4957354189243752,3,5,4,1.4957354189243752,3,-3,6,0,2,6,2,6,-6,0,0,4.516
3,R_1lrWlqblZ3mTGMR,7,f,1,1,6857.200000047684,Religious exemptions for discrimination laws,Defund the police,-1,1,-3,5,2,-2.2062097429134533,-2,6,3,-1.5892188826071485,3,-2,5,-1,-1,5,1,5,-5,-1,0,6.857200000047683
3,R_1lrWlqblZ3mTGMR,8,j,2,0,17814,Dorms determined by gender identity,Physician-assisted suicide,-1,-1,3,5,4,1.4957354189243752,-1,5,2,-0.9722280223008438,-3,1,4,-4,0,4,0,-4,4,4,1,17.814
3,R_1lrWlqblZ3mTGMR,9,j,2,0,8396.399999976158,Safe injection locations,Ban on research with animals,-1,1,3,7,4,1.4957354189243752,1,3,4,0.2617536983117657,-3,1,4,-2,-4,4,4,-4,4,2,1,8.396399999976158
3,R_1lrWlqblZ3mTGMR,10,j,2,0,13569.600000023842,Ban on ethnic Halloween costumes,Dorms determined by gender identity,1,1,0,4,2,-0.35523716199453903,3,5,4,1.4957354189243752,0,3,3,3,1,3,1,-3,3,-3,1,13.569600000023842
3,R_1lrWlqblZ3mTGMR,11,j,2,0,9218.899999976158,Safe injection locations,Ban on research with animals,1,-1,3,7,4,1.4957354189243752,1,3,4,0.2617536983117657,3,-1,-4,-2,-4,4,4,4,-4,2,1,9.218899999976157
3,R_1lrWlqblZ3mTGMR,12,j,2,0,3754.899999976158,Abortion rights,Black Lives Matter,-1,-1,2,4,4,0.8787445586180704,3,7,4,1.4957354189243752,-2,-3,-1,1,3,1,3,1,-1,-1,1,3.7548999999761583
3,R_1lrWlqblZ3mTGMR,13,j,2,0,11444.799999952316,Climate change legislation,Religious exemptions for discrimination laws,-1,1,3,8,4,1.4957354189243752,-3,5,2,-2.2062097429134533,-3,-3,0,-6,-3,0,3,0,0,6,1,11.444799999952316
3,R_1lrWlqblZ3mTGMR,14,f,1,1,9512.100000023842,Safe injection locations,Legalization of marijuana,-1,1,3,7,4,1.4957354189243752,-2,8,1,-1.5892188826071485,-3,-2,-1,5,-1,1,1,-1,1,5,0,9.512100000023842
3,R_1lrWlqblZ3mTGMR,15,f,1,1,5502.700000047684,Climate change legislation,U.S. drone strikes in Afghanistan,-1,1,3,8,4,1.4957354189243752,3,5,4,1.4957354189243752,-3,3,-6,0,3,6,3,-6,6,0,0,5.502700000047684
3,R_1lrWlqblZ3mTGMR,16,f,1,1,8076.899999976158,U.S. drone strikes in Afghanistan,Detention of migrant children,1,-1,3,5,4,1.4957354189243752,0,3,3,-0.35523716199453903,3,-0,3,3,2,3,2,3,-3,3,0,8.076899999976158
3,R_1lrWlqblZ3mTGMR,17,j,2,0,908.2000000476837,U.S. drone strikes in Afghanistan,Safe injection locations,-1,-1,3,5,4,1.4957354189243752,3,7,4,1.4957354189243752,-3,-3,0,0,2,0,2,0,0,0,1,0.9082000000476838
3,R_1lrWlqblZ3mTGMR,18,j,2,0,5184.399999976158,Religious exemptions for discrimination laws,Legalization of marijuana,-1,-1,-3,5,2,-2.2062097429134533,-2,8,1,-1.5892188826071485,3,2,-1,1,3,1,3,1,-1,-1,1,5.184399999976158
3,R_1lrWlqblZ3mTGMR,19,j,2,0,4611.100000023842,U.S. drone strikes in Afghanistan,Ban on research with animals,1,1,3,5,4,1.4957354189243752,1,3,4,0.2617536983117657,3,1,-2,-2,-2,2,2,2,-2,2,1,4.611100000023842
3,R_1lrWlqblZ3mTGMR,20,j,2,0,3772.100000023842,Religious exemptions for discrimination laws,Abortion rights,-1,-1,-3,5,2,-2.2062097429134533,2,4,4,0.8787445586180704,3,-2,-5,5,-1,5,1,5,-5,-5,1,3.772100000023842
3,R_1lrWlqblZ3mTGMR,21,f,1,1,6344.199999928474,War on Drugs,Safe injection locations,-1,1,1,7,2,0.2617536983117657,3,7,4,1.4957354189243752,-1,3,-4,-2,0,4,0,-4,4,-2,0,6.344199999928475
3,R_1lrWlqblZ3mTGMR,22,j,2,0,3423.3000000715256,Religious exemptions for discrimination laws,War on Drugs,-1,-1,-3,5,2,-2.2062097429134533,1,7,2,0.2617536983117657,3,-1,-4,4,2,4,2,4,-4,-4,1,3.4233000000715257
3,R_1lrWlqblZ3mTGMR,23,f,1,1,12294.100000023842,Mask mandates,Safe injection locations,-1,-1,1,4,3,0.2617536983117657,3,7,4,1.4957354189243752,-1,-3,2,-2,-3,2,3,2,-2,-2,0,12.294100000023843
3,R_1lrWlqblZ3mTGMR,24,j,2,0,4222.299999952316,Dorms determined by gender identity,Legalization of marijuana,-1,1,3,5,4,1.4957354189243752,-2,8,1,-1.5892188826071485,-3,-2,1,-5,3,1,3,-1,1,5,1,4.222299999952316
3,R_1lrWlqblZ3mTGMR,25,f,1,1,6446.100000023842,Black Lives Matter,Safe injection locations,1,-1,3,7,4,1.4957354189243752,3,7,4,1.4957354189243752,3,-3,6,0,0,6,0,6,-6,0,0,6.446100000023842
3,R_1lrWlqblZ3mTGMR,26,f,1,1,2299.100000023842,Climate change legislation,Black Lives Matter,-1,-1,3,8,4,1.4957354189243752,3,7,4,1.4957354189243752,-3,-3,0,0,1,0,1,0,0,0,0,2.299100000023842
3,R_1lrWlqblZ3mTGMR,27,j,2,0,1883.8999999761581,Abortion rights,Safe injection locations,1,1,2,4,4,0.8787445586180704,3,7,4,1.4957354189243752,2,3,1,1,3,1,3,-1,1,-1,1,1.883899999976158
3,R_1lrWlqblZ3mTGMR,28,j,2,0,2374.4000000953674,Safe injection locations,Legalization of marijuana,1,1,3,7,4,1.4957354189243752,-2,8,1,-1.5892188826071485,3,-2,-5,-5,1,5,1,5,-5,5,1,2.3744000000953673
3,R_1lrWlqblZ3mTGMR,29,j,2,0,2517.600000023842,Ban on ethnic Halloween costumes,Safe injection locations,-1,-1,0,4,2,-0.35523716199453903,3,7,4,1.4957354189243752,-0,-3,-3,3,3,3,3,3,-3,-3,1,2.5176000000238417
3,R_1lrWlqblZ3mTGMR,30,f,1,1,1977.7000000476837,Safe injection locations,Mask mandates,-1,1,3,7,4,1.4957354189243752,1,4,3,0.2617536983117657,-3,1,-4,2,3,4,3,-4,4,2,0,1.9777000000476836
3,R_1lrWlqblZ3mTGMR,31,f,1,1,1415.5,Safe injection locations,Defund the police,1,1,3,7,4,1.4957354189243752,-2,6,3,-1.5892188826071485,3,-2,5,5,1,5,1,5,-5,5,0,1.4155
3,R_1lrWlqblZ3mTGMR,32,j,2,0,2216,Dorms determined by gender identity,Abortion rights,1,1,3,5,4,1.4957354189243752,2,4,4,0.8787445586180704,3,2,-1,-1,-1,1,1,1,-1,1,1,2.216
3,R_1lrWlqblZ3mTGMR,33,j,2,0,2568.5,Safe injection locations,Physician-assisted suicide,1,-1,3,7,4,1.4957354189243752,-1,5,2,-0.9722280223008438,3,1,-2,-4,-2,2,2,2,-2,4,1,2.5685
3,R_1lrWlqblZ3mTGMR,34,j,2,0,2839.100000023842,Black Lives Matter,Bathrooms restricted based on biological sex,-1,1,3,7,4,1.4957354189243752,2,5,4,0.8787445586180704,-3,2,5,-1,-2,5,2,-5,5,1,1,2.839100000023842
3,R_1lrWlqblZ3mTGMR,35,f,1,1,1531.1000000238419,Black Lives Matter,Defund the police,1,-1,3,7,4,1.4957354189243752,-2,6,3,-1.5892188826071485,3,2,1,5,1,1,1,1,-1,5,0,1.531100000023842
3,R_1lrWlqblZ3mTGMR,36,f,1,1,1567.6000000238419,Dorms determined by gender identity,Stop police brutality,1,-1,3,5,4,1.4957354189243752,0,5,3,-0.35523716199453903,3,-0,3,3,0,3,0,3,-3,3,0,1.567600000023842
3,R_1lrWlqblZ3mTGMR,37,j,2,0,2082.5,Religious exemptions for discrimination laws,Lift COVID lockdowns,-1,-1,-3,5,2,-2.2062097429134533,-1,7,2,-0.9722280223008438,3,1,-2,2,2,2,2,2,-2,-2,1,2.0825
3,R_1lrWlqblZ3mTGMR,38,f,1,1,9291.200000047684,Black Lives Matter,Religious exemptions for discrimination laws,-1,-1,3,7,4,1.4957354189243752,-3,5,2,-2.2062097429134533,-3,3,-6,6,2,6,2,-6,6,6,0,9.291200000047684
3,R_1lrWlqblZ3mTGMR,39,f,1,1,3475.399999976158,Build southern border wall,Black Lives Matter,1,1,2,3,4,0.8787445586180704,3,7,4,1.4957354189243752,2,3,-1,-1,-4,1,4,-1,1,-1,0,3.4753999999761582
3,R_1lrWlqblZ3mTGMR,40,j,2,0,2437,Remove Christopher Columbus statues,U.S. drone strikes in Afghanistan,-1,-1,1,5,2,0.2617536983117657,3,5,4,1.4957354189243752,-1,-3,-2,2,0,2,0,2,-2,-2,1,2.437
3,R_1lrWlqblZ3mTGMR,41,j,2,0,3046,U.S. drone strikes in Afghanistan,Raise the minimum wage,-1,1,3,5,4,1.4957354189243752,2,5,4,0.8787445586180704,-3,2,5,-1,0,5,0,-5,5,1,1,3.046
3,R_1lrWlqblZ3mTGMR,42,j,2,0,2342.5,Black Lives Matter,Allow alt-right speakers on campus,1,-1,3,7,4,1.4957354189243752,2,3,3,0.8787445586180704,3,-2,-5,-1,-4,5,4,5,-5,1,1,2.3425
3,R_1lrWlqblZ3mTGMR,43,f,1,1,11470.599999904633,Safe injection locations,Increased Gun regulations,1,1,3,7,4,1.4957354189243752,-1,4,4,-0.9722280223008438,3,-1,4,4,3,4,3,4,-4,4,0,11.470599999904632
3,R_1lrWlqblZ3mTGMR,44,j,2,0,2549.7000000476837,Increased Gun regulations,Dorms determined by gender identity,-1,-1,-1,4,4,-0.9722280223008438,3,5,4,1.4957354189243752,1,-3,-4,4,1,4,1,4,-4,-4,1,2.5497000000476837
3,R_1lrWlqblZ3mTGMR,45,f,1,1,2139.2000000476837,Allow alt-right speakers on campus,Safe injection locations,1,-1,2,3,3,0.8787445586180704,3,7,4,1.4957354189243752,2,-3,5,-1,-4,5,4,5,-5,-1,0,2.139200000047684
3,R_1lrWlqblZ3mTGMR,46,f,1,1,2450.5,Safe injection locations,Raise the minimum wage,-1,-1,3,7,4,1.4957354189243752,2,5,4,0.8787445586180704,-3,-2,-1,1,2,1,2,-1,1,1,0,2.4505
3,R_1lrWlqblZ3mTGMR,47,j,2,0,1711,Raise the minimum wage,Dorms determined by gender identity,-1,1,2,5,4,0.8787445586180704,3,5,4,1.4957354189243752,-2,3,5,1,0,5,0,-5,5,-1,1,1.711
3,R_1lrWlqblZ3mTGMR,48,f,1,1,1790.5,Black Lives Matter,Bathrooms restricted based on biological sex,1,1,3,7,4,1.4957354189243752,2,5,4,0.8787445586180704,3,2,1,1,2,1,2,1,-1,1,0,1.7905
3,R_1lrWlqblZ3mTGMR,49,f,1,1,2895.6999999284744,Religious exemptions for discrimination laws,Abortion rights,1,1,-3,5,2,-2.2062097429134533,2,4,4,0.8787445586180704,-3,2,-5,-5,1,5,1,-5,5,-5,0,2.8956999999284743
3,R_1lrWlqblZ3mTGMR,50,j,2,0,2925.3000000715256,Mask mandates,U.S. drone strikes in Afghanistan,-1,1,1,4,3,0.2617536983117657,3,5,4,1.4957354189243752,-1,3,4,2,1,4,1,-4,4,-2,1,2.9253000000715255
3,R_1lrWlqblZ3mTGMR,51,f,1,1,1643.2000000476837,Climate change legislation,U.S. drone strikes in Afghanistan,1,-1,3,8,4,1.4957354189243752,3,5,4,1.4957354189243752,3,-3,6,0,3,6,3,6,-6,0,0,1.6432000000476836
3,R_1lrWlqblZ3mTGMR,52,j,2,0,1405.7000000476837,Black Lives Matter,Abolishing fraternities,-1,1,3,7,4,1.4957354189243752,0,5,1,-0.35523716199453903,-3,0,3,-3,-2,3,2,-3,3,3,1,1.4057000000476838
3,R_1lrWlqblZ3mTGMR,53,j,2,0,1867.6000000238419,U.S. drone strikes in Afghanistan,Ban on research with animals,1,-1,3,5,4,1.4957354189243752,1,3,4,0.2617536983117657,3,-1,-4,-2,-2,4,2,4,-4,2,1,1.867600000023842
3,R_1lrWlqblZ3mTGMR,54,j,2,0,1501.1999999284744,Defund the police,Safe injection locations,-1,-1,-2,6,3,-1.5892188826071485,3,7,4,1.4957354189243752,2,-3,-5,5,1,5,1,5,-5,-5,1,1.5011999999284744
3,R_1lrWlqblZ3mTGMR,55,j,2,0,1721.2000000476837,Dorms determined by gender identity,Tuition increases,1,-1,3,5,4,1.4957354189243752,-1,5,2,-0.9722280223008438,3,1,-2,-4,0,2,0,2,-2,4,1,1.7212000000476837
3,R_1lrWlqblZ3mTGMR,56,f,1,1,1457.7000000476837,Mandatory training on sexual consent,Black Lives Matter,1,-1,0,6,2,-0.35523716199453903,3,7,4,1.4957354189243752,0,-3,3,-3,-1,3,1,3,-3,-3,0,1.4577000000476836
3,R_1lrWlqblZ3mTGMR,57,j,2,0,1582.5999999046326,Religious exemptions for discrimination laws,Defund the police,1,1,-3,5,2,-2.2062097429134533,-2,6,3,-1.5892188826071485,-3,-2,1,1,1,1,1,-1,1,-1,1,1.5825999999046325
3,R_1lrWlqblZ3mTGMR,58,f,1,1,2989.399999976158,Black Lives Matter,War on Drugs,1,1,3,7,4,1.4957354189243752,1,7,2,0.2617536983117657,3,1,2,2,0,2,0,2,-2,2,0,2.989399999976158
3,R_1lrWlqblZ3mTGMR,59,f,1,1,2266.600000023842,Black Lives Matter,Legalization of marijuana,-1,-1,3,7,4,1.4957354189243752,-2,8,1,-1.5892188826071485,-3,2,-5,5,-1,5,1,-5,5,5,0,2.2666000000238418
3,R_1lrWlqblZ3mTGMR,60,j,2,0,2308.6999999284744,Black Lives Matter,Legalization of marijuana,1,-1,3,7,4,1.4957354189243752,-2,8,1,-1.5892188826071485,3,2,-1,-5,1,1,1,1,-1,5,1,2.3086999999284745
3,R_1lrWlqblZ3mTGMR,61,f,1,1,1886.8999999761581,Ban on ethnic Halloween costumes,Safe injection locations,1,1,0,4,2,-0.35523716199453903,3,7,4,1.4957354189243752,0,3,-3,-3,-3,3,3,-3,3,-3,0,1.8868999999761582
3,R_1lrWlqblZ3mTGMR,62,f,1,1,2292.8000000715256,Ban on research with animals,Safe injection locations,1,1,1,3,4,0.2617536983117657,3,7,4,1.4957354189243752,1,3,-2,-2,-4,2,4,-2,2,-2,0,2.2928000000715256
3,R_1lrWlqblZ3mTGMR,63,f,1,1,1447.7999999523163,Dorms determined by gender identity,War on Drugs,-1,-1,3,5,4,1.4957354189243752,1,7,2,0.2617536983117657,-3,-1,-2,2,-2,2,2,-2,2,2,0,1.4477999999523163
3,R_1lrWlqblZ3mTGMR,64,f,1,1,1407.3999999761581,Safe injection locations,Physician-assisted suicide,-1,1,3,7,4,1.4957354189243752,-1,5,2,-0.9722280223008438,-3,-1,-2,4,2,2,2,-2,2,4,0,1.4073999999761582
3,R_1lrWlqblZ3mTGMR,65,f,1,1,1596,Ban on research with animals,Dorms determined by gender identity,1,-1,1,3,4,0.2617536983117657,3,5,4,1.4957354189243752,1,-3,4,-2,-2,4,2,4,-4,-2,0,1.596
3,R_1lrWlqblZ3mTGMR,66,f,1,1,2350.5,Black Lives Matter,Climate change legislation,1,-1,3,7,4,1.4957354189243752,3,8,4,1.4957354189243752,3,-3,6,0,-1,6,1,6,-6,0,0,2.3505
3,R_1lrWlqblZ3mTGMR,67,f,1,1,9657.399999976158,Defund the police,Black Lives Matter,1,-1,-2,6,3,-1.5892188826071485,3,7,4,1.4957354189243752,-2,-3,1,-5,-1,1,1,1,-1,-5,0,9.657399999976159
3,R_1lrWlqblZ3mTGMR,68,f,1,1,1683.5,Mask mandates,Dorms determined by gender identity,-1,-1,1,4,3,0.2617536983117657,3,5,4,1.4957354189243752,-1,-3,2,-2,-1,2,1,2,-2,-2,0,1.6835
3,R_1lrWlqblZ3mTGMR,69,f,1,1,1435.3999999761581,U.S. drone strikes in Afghanistan,Mandatory training on sexual consent,1,-1,3,5,4,1.4957354189243752,0,6,2,-0.35523716199453903,3,-0,3,3,-1,3,1,3,-3,3,0,1.4353999999761582
3,R_1lrWlqblZ3mTGMR,70,f,1,1,1310.5,Abolishing fraternities,Black Lives Matter,1,1,0,5,1,-0.35523716199453903,3,7,4,1.4957354189243752,0,3,-3,-3,-2,3,2,-3,3,-3,0,1.3105
3,R_1lrWlqblZ3mTGMR,71,j,2,0,909.3999999761581,Allow alt-right speakers on campus,Dorms determined by gender identity,1,1,2,3,3,0.8787445586180704,3,5,4,1.4957354189243752,2,3,1,1,2,1,2,-1,1,-1,1,0.9093999999761582
3,R_1lrWlqblZ3mTGMR,72,f,1,1,2037.4000000953674,Black Lives Matter,Mandatory training on sexual consent,1,1,3,7,4,1.4957354189243752,0,6,2,-0.35523716199453903,3,0,3,3,1,3,1,3,-3,3,0,2.0374000000953676
3,R_1lrWlqblZ3mTGMR,73,f,1,1,1546.3999999761581,Bathrooms restricted based on biological sex,Safe injection locations,-1,1,2,5,4,0.8787445586180704,3,7,4,1.4957354189243752,-2,3,-5,-1,-2,5,2,-5,5,-1,0,1.5463999999761582
3,R_1lrWlqblZ3mTGMR,74,f,1,1,1130.6000000238419,Ban on ethnic Halloween costumes,Dorms determined by gender identity,1,-1,0,4,2,-0.35523716199453903,3,5,4,1.4957354189243752,0,-3,3,-3,-1,3,1,3,-3,-3,0,1.1306000000238419
3,R_1lrWlqblZ3mTGMR,75,f,1,1,405.7999999523163,Build southern border wall,Black Lives Matter,-1,-1,2,3,4,0.8787445586180704,3,7,4,1.4957354189243752,-2,-3,1,-1,-4,1,4,1,-1,-1,0,0.4057999999523163
3,R_1lrWlqblZ3mTGMR,76,f,1,1,1661.3000000715256,Safe injection locations,Defund Planned Parenthood,1,-1,3,7,4,1.4957354189243752,0,3,3,-0.35523716199453903,3,-0,3,3,4,3,4,3,-3,3,0,1.6613000000715257
3,R_1lrWlqblZ3mTGMR,77,j,2,0,1257.8000000715256,Mask mandates,Black Lives Matter,1,1,1,4,3,0.2617536983117657,3,7,4,1.4957354189243752,1,3,2,2,3,2,3,-2,2,-2,1,1.2578000000715255
3,R_1lrWlqblZ3mTGMR,78,j,2,0,2372.7000000476837,Religious exemptions for discrimination laws,Raise the minimum wage,1,-1,-3,5,2,-2.2062097429134533,2,5,4,0.8787445586180704,-3,-2,1,5,0,1,0,-1,1,-5,1,2.3727000000476837
3,R_1lrWlqblZ3mTGMR,79,f,1,1,1885.6999999284744,U.S. drone strikes in Afghanistan,Allow alt-right speakers on campus,-1,1,3,5,4,1.4957354189243752,2,3,3,0.8787445586180704,-3,2,-5,1,2,5,2,-5,5,1,0,1.8856999999284745
3,R_1lrWlqblZ3mTGMR,80,f,1,1,1577.8999999761581,Safe injection locations,Ban on research with animals,-1,-1,3,7,4,1.4957354189243752,1,3,4,0.2617536983117657,-3,-1,-2,2,4,2,4,-2,2,2,0,1.577899999976158
3,R_1lrWlqblZ3mTGMR,81,j,2,0,2307.8000000715256,Dorms determined by gender identity,Recognize Jerusalem as capital of Israel,-1,1,3,5,4,1.4957354189243752,0,5,1,-0.35523716199453903,-3,0,3,-3,0,3,0,-3,3,3,1,2.3078000000715257
3,R_1lrWlqblZ3mTGMR,82,f,1,1,1229.1000000238419,Black Lives Matter,Climate change legislation,-1,1,3,7,4,1.4957354189243752,3,8,4,1.4957354189243752,-3,3,-6,0,-1,6,1,-6,6,0,0,1.229100000023842
3,R_1lrWlqblZ3mTGMR,83,f,1,1,1068.1999999284744,Lift COVID lockdowns,Safe injection locations,-1,-1,-1,7,2,-0.9722280223008438,3,7,4,1.4957354189243752,1,-3,4,-4,0,4,0,4,-4,-4,0,1.0681999999284744
3,R_1lrWlqblZ3mTGMR,84,j,2,0,1218.1000000238419,"Boycott, Divest, and Sanction Israel",U.S. drone strikes in Afghanistan,1,1,2,5,3,0.8787445586180704,3,5,4,1.4957354189243752,2,3,1,1,0,1,0,-1,1,-1,1,1.2181000000238418
3,R_1lrWlqblZ3mTGMR,85,j,2,0,2521,Black Lives Matter,Religious exemptions for discrimination laws,1,-1,3,7,4,1.4957354189243752,-3,5,2,-2.2062097429134533,3,3,0,-6,-2,0,2,0,0,6,1,2.521
3,R_1lrWlqblZ3mTGMR,86,j,2,0,1388.7000000476837,Religious exemptions for discrimination laws,Mask mandates,-1,1,-3,5,2,-2.2062097429134533,1,4,3,0.2617536983117657,3,1,-2,4,-1,2,1,2,-2,-4,1,1.3887000000476837
3,R_1lrWlqblZ3mTGMR,87,j,2,0,1524.3000000715256,Allow alt-right speakers on campus,Dorms determined by gender identity,-1,-1,2,3,3,0.8787445586180704,3,5,4,1.4957354189243752,-2,-3,-1,1,2,1,2,1,-1,-1,1,1.5243000000715257
3,R_1lrWlqblZ3mTGMR,88,j,2,0,1180.7000000476837,Dorms determined by gender identity,Lift COVID lockdowns,-1,-1,3,5,4,1.4957354189243752,-1,7,2,-0.9722280223008438,-3,1,4,-4,2,4,2,-4,4,4,1,1.1807000000476837
3,R_1lrWlqblZ3mTGMR,89,j,2,0,1180.7000000476837,Dorms determined by gender identity,Legalization of marijuana,-1,-1,3,5,4,1.4957354189243752,-2,8,1,-1.5892188826071485,-3,2,5,-5,3,5,3,-5,5,5,1,1.1807000000476837
3,R_1lrWlqblZ3mTGMR,90,f,1,1,2420.899999976158,U.S. drone strikes in Afghanistan,Abortion rights,-1,-1,3,5,4,1.4957354189243752,2,4,4,0.8787445586180704,-3,-2,-1,1,1,1,1,-1,1,1,0,2.4208999999761582
3,R_1lrWlqblZ3mTGMR,91,f,1,1,1079.8000000715256,Defund the police,U.S. drone strikes in Afghanistan,-1,-1,-2,6,3,-1.5892188826071485,3,5,4,1.4957354189243752,2,-3,5,-5,1,5,1,5,-5,-5,0,1.0798000000715255
3,R_1lrWlqblZ3mTGMR,94,f,1,1,191.39999997615814,Ban on research with animals,U.S. drone strikes in Afghanistan,-1,-1,1,3,4,0.2617536983117657,3,5,4,1.4957354189243752,-1,-3,2,-2,-2,2,2,2,-2,-2,0,0.19139999997615814
3,R_1lrWlqblZ3mTGMR,95,f,1,1,1592.8999999761581,Safe injection locations,Abortion rights,1,-1,3,7,4,1.4957354189243752,2,4,4,0.8787445586180704,3,-2,5,1,3,5,3,5,-5,1,0,1.5928999999761582
15,R_8pQnbYPPeamBQ2J,1,f,1,1,2656.7000000476837,Religious exemptions for discrimination laws,Stop police brutality,-1,-1,0,0,1,-0.3518989217530848,3,8,3,0.8992972444801055,-0,-3,3,-3,-8,3,8,3,-3,-3,0,2.656700000047684
15,R_8pQnbYPPeamBQ2J,2,j,2,0,3660.900000035763,Tuition increases,Hardening schools/Arming teachers,1,1,-3,6,2,-1.603095087986275,-3,7,1,-1.603095087986275,-3,-3,0,0,1,0,1,0,0,0,1,3.6609000000357628
15,R_8pQnbYPPeamBQ2J,3,j,2,0,4042.800000011921,Mandatory vaccinations,Ban on research with animals,-1,1,3,8,2,0.8992972444801055,0,4,1,-0.3518989217530848,-3,0,3,-3,-4,3,4,-3,3,3,1,4.042800000011921
15,R_8pQnbYPPeamBQ2J,4,j,2,0,6056.099999964237,U.S. drone strikes in Afghanistan,Hardening schools/Arming teachers,1,-1,2,4,1,0.48223185573570876,-3,7,1,-1.603095087986275,2,3,1,-5,3,1,3,-1,1,5,1,6.056099999964237
15,R_8pQnbYPPeamBQ2J,5,f,1,1,8103.099999964237,Tuition increases,Hardening schools/Arming teachers,-1,-1,-3,6,2,-1.603095087986275,-3,7,1,-1.603095087986275,3,3,0,0,-1,0,1,0,0,0,0,8.103099999964238
15,R_8pQnbYPPeamBQ2J,6,j,2,0,4446.5,Affirmative action,Tuition increases,1,-1,1,3,2,0.065166466991312,-3,6,2,-1.603095087986275,1,3,2,-4,3,2,3,-2,2,4,1,4.4465
15,R_8pQnbYPPeamBQ2J,7,j,2,0,4220.399999976158,University Campus should be a Sanctuary,Tuition increases,-1,-1,1,4,1,0.065166466991312,-3,6,2,-1.603095087986275,-1,3,4,-4,2,4,2,-4,4,4,1,4.220399999976158
15,R_8pQnbYPPeamBQ2J,8,j,2,0,3246.599999964237,Hardening schools/Arming teachers,Tuition increases,1,-1,-3,7,1,-1.603095087986275,-3,6,2,-1.603095087986275,-3,3,6,0,-1,6,1,-6,6,0,1,3.2465999999642374
15,R_8pQnbYPPeamBQ2J,9,j,2,0,1953.4000000357628,Mandatory drug tests for welfare recipients,Tuition increases,1,-1,-3,8,2,-1.603095087986275,-3,6,2,-1.603095087986275,-3,3,6,0,-2,6,2,-6,6,0,1,1.9534000000357628
15,R_8pQnbYPPeamBQ2J,10,f,1,1,6589.699999988079,Black Lives Matter,Tuition increases,1,-1,2,6,2,0.48223185573570876,-3,6,2,-1.603095087986275,2,3,-1,5,0,1,0,-1,1,5,0,6.589699999988079
15,R_8pQnbYPPeamBQ2J,11,f,1,1,2168.5,Mandatory trigger warnings,Hardening schools/Arming teachers,-1,1,0,2,1,-0.3518989217530848,-3,7,1,-1.603095087986275,-0,-3,3,3,-5,3,5,3,-3,3,0,2.1685
15,R_8pQnbYPPeamBQ2J,12,j,2,0,4539.800000011921,Abolishing fraternities,Mandatory vaccinations,-1,1,2,6,1,0.48223185573570876,3,8,2,0.8992972444801055,-2,3,5,1,2,5,2,-5,5,-1,1,4.539800000011921
15,R_8pQnbYPPeamBQ2J,13,f,1,1,4322.600000023842,Hardening schools/Arming teachers,Cuts to National Parks budget,-1,1,-3,7,1,-1.603095087986275,-2,4,1,-1.1860296992418784,3,-2,5,-1,3,5,3,5,-5,-1,0,4.322600000023842
15,R_8pQnbYPPeamBQ2J,14,f,1,1,3891.7999999523163,University Campus should be a Sanctuary,Mandatory drug tests for welfare recipients,1,-1,1,4,1,0.065166466991312,-3,8,2,-1.603095087986275,1,3,-2,4,-4,2,4,-2,2,4,0,3.8917999999523163
15,R_8pQnbYPPeamBQ2J,15,j,2,0,7747.899999976158,Hardening schools/Arming teachers,Affirmative action,1,-1,-3,7,1,-1.603095087986275,1,3,2,0.065166466991312,-3,-1,2,4,-4,2,4,-2,2,-4,1,7.747899999976158
15,R_8pQnbYPPeamBQ2J,16,j,2,0,3698.7000000476837,Abortion rights,Tuition increases,1,-1,2,5,2,0.48223185573570876,-3,6,2,-1.603095087986275,2,3,1,-5,1,1,1,-1,1,5,1,3.6987000000476837
15,R_8pQnbYPPeamBQ2J,17,j,2,0,1798.1000000238419,Hardening schools/Arming teachers,Abortion rights,1,1,-3,7,1,-1.603095087986275,2,5,2,0.48223185573570876,-3,2,5,5,-2,5,2,-5,5,-5,1,1.7981000000238418
15,R_8pQnbYPPeamBQ2J,18,j,2,0,1814,Remove police from schools,Tuition increases,-1,-1,-3,2,1,-1.603095087986275,-3,6,2,-1.603095087986275,3,3,0,0,4,0,4,0,0,0,1,1.814
15,R_8pQnbYPPeamBQ2J,19,j,2,0,3322,Religious exemptions for discrimination laws,Mandatory drug tests for welfare recipients,-1,-1,0,0,1,-0.3518989217530848,-3,8,2,-1.603095087986275,-0,3,3,-3,8,3,8,-3,3,3,1,3.322
15,R_8pQnbYPPeamBQ2J,20,f,1,1,1962.300000011921,Tuition increases,Abortion rights,-1,-1,-3,6,2,-1.603095087986275,2,5,2,0.48223185573570876,3,-2,5,-5,1,5,1,5,-5,-5,0,1.9623000000119208
15,R_8pQnbYPPeamBQ2J,21,j,2,0,5524.5,Defund the police,Hardening schools/Arming teachers,-1,-1,3,8,3,0.8992972444801055,-3,7,1,-1.603095087986275,-3,3,6,-6,-1,6,1,-6,6,6,1,5.5245
15,R_8pQnbYPPeamBQ2J,22,f,1,1,4154.199999988079,Hardening schools/Arming teachers,Affirmative action,-1,-1,-3,7,1,-1.603095087986275,1,3,2,0.065166466991312,3,-1,4,-4,4,4,4,4,-4,-4,0,4.154199999988079
15,R_8pQnbYPPeamBQ2J,23,f,1,1,4140.300000011921,Mandatory vaccinations,U.S. drone strikes in Afghanistan,-1,1,3,8,2,0.8992972444801055,2,4,1,0.48223185573570876,-3,2,-5,1,4,5,4,-5,5,1,0,4.140300000011921
15,R_8pQnbYPPeamBQ2J,24,j,2,0,2177.100000023842,Ban on research with animals,Tuition increases,1,-1,0,4,1,-0.3518989217530848,-3,6,2,-1.603095087986275,0,3,3,-3,2,3,2,-3,3,3,1,2.177100000023842
15,R_8pQnbYPPeamBQ2J,25,j,2,0,3557.199999988079,Tuition increases,Cuts to National Parks budget,1,-1,-3,6,2,-1.603095087986275,-2,4,1,-1.1860296992418784,-3,2,5,1,-2,5,2,-5,5,-1,1,3.5571999999880792
15,R_8pQnbYPPeamBQ2J,26,j,2,0,2030.1000000238419,University Campus should be a Sanctuary,Tuition increases,1,-1,1,4,1,0.065166466991312,-3,6,2,-1.603095087986275,1,3,2,-4,2,2,2,-2,2,4,1,2.030100000023842
15,R_8pQnbYPPeamBQ2J,27,j,2,0,5644.699999988079,Hardening schools/Arming teachers,Gun-free campus police,1,-1,-3,7,1,-1.603095087986275,2,6,1,0.48223185573570876,-3,-2,1,5,-1,1,1,-1,1,-5,1,5.644699999988079
15,R_8pQnbYPPeamBQ2J,28,j,2,0,6523.600000023842,Dorms determined by gender identity,Stop police brutality,1,1,0,2,1,-0.3518989217530848,3,8,3,0.8992972444801055,0,3,3,3,6,3,6,-3,3,-3,1,6.523600000023841
15,R_8pQnbYPPeamBQ2J,29,j,2,0,2175.7999999523163,Hardening schools/Arming teachers,Hardening schools/Arming teachers,1,-1,-3,7,1,-1.603095087986275,-3,7,1,-1.603095087986275,-3,3,6,0,0,6,0,-6,6,0,1,2.175799999952316
15,R_8pQnbYPPeamBQ2J,30,j,2,0,6252.100000023842,Remove police from schools,Mandatory drug tests for welfare recipients,1,-1,-3,2,1,-1.603095087986275,-3,8,2,-1.603095087986275,-3,3,6,0,6,6,6,-6,6,0,1,6.252100000023842
15,R_8pQnbYPPeamBQ2J,31,f,1,1,1733.9000000357628,U.S. drone strikes in Afghanistan,Hardening schools/Arming teachers,1,1,2,4,1,0.48223185573570876,-3,7,1,-1.603095087986275,2,-3,5,5,-3,5,3,5,-5,5,0,1.7339000000357627
15,R_8pQnbYPPeamBQ2J,32,j,2,0,1691.0999999642372,Religious exemptions for discrimination laws,Hardening schools/Arming teachers,1,-1,0,0,1,-0.3518989217530848,-3,7,1,-1.603095087986275,0,3,3,-3,7,3,7,-3,3,3,1,1.6910999999642373
15,R_8pQnbYPPeamBQ2J,33,j,2,0,4763.800000011921,Tuition increases,Cuts to National Parks budget,1,1,-3,6,2,-1.603095087986275,-2,4,1,-1.1860296992418784,-3,-2,1,1,-2,1,2,-1,1,-1,1,4.763800000011921
15,R_8pQnbYPPeamBQ2J,34,f,1,1,2633.800000011921,Affirmative action,Allow alt-right speakers on campus,-1,1,1,3,2,0.065166466991312,-3,8,1,-1.603095087986275,-1,-3,2,4,-5,2,5,2,-2,4,0,2.633800000011921
15,R_8pQnbYPPeamBQ2J,35,j,2,0,1816.1000000238419,Religious exemptions for discrimination laws,Tuition increases,-1,-1,0,0,1,-0.3518989217530848,-3,6,2,-1.603095087986275,-0,3,3,-3,6,3,6,-3,3,3,1,1.8161000000238419
15,R_8pQnbYPPeamBQ2J,36,f,1,1,6599.5,Hardening schools/Arming teachers,Ban on research with animals,1,1,-3,7,1,-1.603095087986275,0,4,1,-0.3518989217530848,-3,0,-3,-3,3,3,3,-3,3,-3,0,6.5995
15,R_8pQnbYPPeamBQ2J,37,f,1,1,1493.6000000238419,Hardening schools/Arming teachers,Remove police from schools,-1,1,-3,7,1,-1.603095087986275,-3,2,1,-1.603095087986275,3,-3,6,0,5,6,5,6,-6,0,0,1.4936000000238419
15,R_8pQnbYPPeamBQ2J,38,f,1,1,2784.400000035763,Climate change legislation,Abortion rights,1,-1,3,8,1,0.8992972444801055,2,5,2,0.48223185573570876,3,-2,5,1,3,5,3,5,-5,1,0,2.7844000000357627
15,R_8pQnbYPPeamBQ2J,39,j,2,0,2952.800000011921,Remove police from schools,Hardening schools/Arming teachers,-1,-1,-3,2,1,-1.603095087986275,-3,7,1,-1.603095087986275,3,3,0,0,5,0,5,0,0,0,1,2.952800000011921
15,R_8pQnbYPPeamBQ2J,40,f,1,1,3133.300000011921,Hardening schools/Arming teachers,University Campus should be a Sanctuary,1,-1,-3,7,1,-1.603095087986275,1,4,1,0.065166466991312,-3,-1,-2,-4,3,2,3,-2,2,-4,0,3.133300000011921
15,R_8pQnbYPPeamBQ2J,41,f,1,1,1737.800000011921,Tuition increases,Remove police from schools,-1,1,-3,6,2,-1.603095087986275,-3,2,1,-1.603095087986275,3,-3,6,0,4,6,4,6,-6,0,0,1.737800000011921
15,R_8pQnbYPPeamBQ2J,42,j,2,0,6423.199999988079,Abortion rights,Tuition increases,-1,1,2,5,2,0.48223185573570876,-3,6,2,-1.603095087986275,-2,-3,-1,-5,1,1,1,1,-1,5,1,6.423199999988079
15,R_8pQnbYPPeamBQ2J,43,f,1,1,994.1999999880791,Hardening schools/Arming teachers,Tuition increases,-1,1,-3,7,1,-1.603095087986275,-3,6,2,-1.603095087986275,3,-3,6,0,1,6,1,6,-6,0,0,0.9941999999880791
15,R_8pQnbYPPeamBQ2J,44,f,1,1,1292.300000011921,Stop police brutality,Ban on research with animals,1,-1,3,8,3,0.8992972444801055,0,4,1,-0.3518989217530848,3,-0,3,3,4,3,4,3,-3,3,0,1.292300000011921
15,R_8pQnbYPPeamBQ2J,45,j,2,0,3297.900000035763,Affirmative action,Remove public Confederate memorials,1,1,1,3,2,0.065166466991312,3,8,3,0.8992972444801055,1,3,2,2,5,2,5,-2,2,-2,1,3.297900000035763
15,R_8pQnbYPPeamBQ2J,46,j,2,0,1704.5,U.S. drone strikes in Afghanistan,Climate change legislation,-1,1,2,4,1,0.48223185573570876,3,8,1,0.8992972444801055,-2,3,5,1,4,5,4,-5,5,-1,1,1.7045
15,R_8pQnbYPPeamBQ2J,47,f,1,1,1218.800000011921,Tuition increases,Tuition increases,-1,1,-3,6,2,-1.603095087986275,-3,6,2,-1.603095087986275,3,-3,6,0,0,6,0,6,-6,0,0,1.218800000011921
15,R_8pQnbYPPeamBQ2J,48,f,1,1,923.6000000238419,Climate change legislation,Tuition increases,1,-1,3,8,1,0.8992972444801055,-3,6,2,-1.603095087986275,3,3,0,6,2,0,2,0,0,6,0,0.9236000000238419
15,R_8pQnbYPPeamBQ2J,49,f,1,1,957.9000000357628,Tuition increases,U.S. drone strikes in Afghanistan,-1,-1,-3,6,2,-1.603095087986275,2,4,1,0.48223185573570876,3,-2,5,-5,2,5,2,5,-5,-5,0,0.9579000000357628
15,R_8pQnbYPPeamBQ2J,50,f,1,1,1814.1000000238419,Hardening schools/Arming teachers,Abortion rights,1,-1,-3,7,1,-1.603095087986275,2,5,2,0.48223185573570876,-3,-2,-1,-5,2,1,2,-1,1,-5,0,1.8141000000238419
15,R_8pQnbYPPeamBQ2J,51,f,1,1,1467.5,Remove public Confederate memorials,Affirmative action,1,-1,3,8,3,0.8992972444801055,1,3,2,0.065166466991312,3,-1,4,2,5,4,5,4,-4,2,0,1.4675
15,R_8pQnbYPPeamBQ2J,52,j,2,0,1930.5,Hardening schools/Arming teachers,Affirmative action,-1,1,-3,7,1,-1.603095087986275,1,3,2,0.065166466991312,3,1,-2,4,-4,2,4,2,-2,-4,1,1.9305
15,R_8pQnbYPPeamBQ2J,53,f,1,1,1285,Tuition increases,Abolishing fraternities,-1,-1,-3,6,2,-1.603095087986275,2,6,1,0.48223185573570876,3,-2,5,-5,0,5,0,5,-5,-5,0,1.285
15,R_8pQnbYPPeamBQ2J,54,f,1,1,2543.699999988079,U.S. drone strikes in Afghanistan,Lift COVID lockdowns,-1,1,2,4,1,0.48223185573570876,-3,8,1,-1.603095087986275,-2,-3,1,5,-4,1,4,1,-1,5,0,2.543699999988079
15,R_8pQnbYPPeamBQ2J,55,j,2,0,1553.1000000238419,Abortion rights,Mandatory vaccinations,1,1,2,5,2,0.48223185573570876,3,8,2,0.8992972444801055,2,3,1,1,3,1,3,-1,1,-1,1,1.553100000023842
15,R_8pQnbYPPeamBQ2J,56,f,1,1,3394.5,Abolishing private prisons,Remove police from schools,1,-1,3,8,2,0.8992972444801055,-3,2,1,-1.603095087986275,3,3,0,6,6,0,6,0,0,6,0,3.3945
15,R_8pQnbYPPeamBQ2J,57,j,2,0,3492,Mandatory drug tests for welfare recipients,Remove police from schools,1,-1,-3,8,2,-1.603095087986275,-3,2,1,-1.603095087986275,-3,3,6,0,-6,6,6,-6,6,0,1,3.492
15,R_8pQnbYPPeamBQ2J,58,f,1,1,3170.800000011921,Hardening schools/Arming teachers,Gun-free campus police,-1,-1,-3,7,1,-1.603095087986275,2,6,1,0.48223185573570876,3,-2,5,-5,1,5,1,5,-5,-5,0,3.170800000011921
15,R_8pQnbYPPeamBQ2J,59,f,1,1,5371.800000011921,Abortion rights,Raise the minimum wage,-1,-1,2,5,2,0.48223185573570876,3,8,3,0.8992972444801055,-2,-3,1,-1,-3,1,3,1,-1,-1,0,5.371800000011921
15,R_8pQnbYPPeamBQ2J,60,f,1,1,2756.600000023842,Remove police from schools,Defund the police,1,-1,-3,2,1,-1.603095087986275,3,8,3,0.8992972444801055,-3,-3,0,-6,-6,0,6,0,0,-6,0,2.756600000023842
15,R_8pQnbYPPeamBQ2J,61,f,1,1,2515.699999988079,On campus concealed carry,Tuition increases,1,1,2,6,1,0.48223185573570876,-3,6,2,-1.603095087986275,2,-3,5,5,0,5,0,5,-5,5,0,2.515699999988079
15,R_8pQnbYPPeamBQ2J,62,j,2,0,3763.099999964237,Mandatory vaccinations,Mandatory training on sexual consent,-1,1,3,8,2,0.8992972444801055,3,8,2,0.8992972444801055,-3,3,6,0,0,6,0,-6,6,0,1,3.763099999964237
15,R_8pQnbYPPeamBQ2J,63,f,1,1,1768.3999999761581,Abolishing private prisons,Hardening schools/Arming teachers,1,1,3,8,2,0.8992972444801055,-3,7,1,-1.603095087986275,3,-3,6,6,1,6,1,6,-6,6,0,1.7683999999761582
15,R_8pQnbYPPeamBQ2J,64,f,1,1,1685.0999999642372,Tuition increases,Mandatory trigger warnings,-1,1,-3,6,2,-1.603095087986275,0,2,1,-0.3518989217530848,3,0,3,-3,4,3,4,3,-3,-3,0,1.6850999999642373
15,R_8pQnbYPPeamBQ2J,65,f,1,1,4252.299999952316,University Campus should be a Sanctuary,Stop police brutality,1,-1,1,4,1,0.065166466991312,3,8,3,0.8992972444801055,1,-3,4,-2,-4,4,4,4,-4,-2,0,4.252299999952316
15,R_8pQnbYPPeamBQ2J,66,f,1,1,2487,U.S. drone strikes in Afghanistan,Hardening schools/Arming teachers,-1,1,2,4,1,0.48223185573570876,-3,7,1,-1.603095087986275,-2,-3,1,5,-3,1,3,1,-1,5,0,2.487
15,R_8pQnbYPPeamBQ2J,67,j,2,0,1293.5,Hardening schools/Arming teachers,Black Lives Matter,-1,1,-3,7,1,-1.603095087986275,2,6,2,0.48223185573570876,3,2,-1,5,-1,1,1,1,-1,-5,1,1.2935
15,R_8pQnbYPPeamBQ2J,68,f,1,1,2668,Religious exemptions for discrimination laws,Hardening schools/Arming teachers,-1,1,0,0,1,-0.3518989217530848,-3,7,1,-1.603095087986275,-0,-3,3,3,-7,3,7,3,-3,3,0,2.668
15,R_8pQnbYPPeamBQ2J,69,j,2,0,2317.100000023842,Ban on research with animals,Hardening schools/Arming teachers,-1,-1,0,4,1,-0.3518989217530848,-3,7,1,-1.603095087986275,-0,3,3,-3,3,3,3,-3,3,3,1,2.3171000000238418
15,R_8pQnbYPPeamBQ2J,70,f,1,1,2176.099999964237,Allow alt-right speakers on campus,Tuition increases,-1,1,-3,8,1,-1.603095087986275,-3,6,2,-1.603095087986275,3,-3,6,0,2,6,2,6,-6,0,0,2.1760999999642374
15,R_8pQnbYPPeamBQ2J,71,f,1,1,2186.100000023842,Lift COVID lockdowns,Gun-free campus police,-1,1,-3,8,1,-1.603095087986275,2,6,1,0.48223185573570876,3,2,1,-5,2,1,2,1,-1,-5,0,2.186100000023842
15,R_8pQnbYPPeamBQ2J,72,f,1,1,1408.9000000357628,University Campus should be a Sanctuary,Hardening schools/Arming teachers,1,1,1,4,1,0.065166466991312,-3,7,1,-1.603095087986275,1,-3,4,4,-3,4,3,4,-4,4,0,1.4089000000357628
15,R_8pQnbYPPeamBQ2J,73,j,2,0,1944.9000000357628,Raise the minimum wage,Gun-free campus police,-1,1,3,8,3,0.8992972444801055,2,6,1,0.48223185573570876,-3,2,5,-1,-2,5,2,-5,5,1,1,1.9449000000357628
15,R_8pQnbYPPeamBQ2J,74,j,2,0,1179.300000011921,U.S. drone strikes in Afghanistan,Tuition increases,1,-1,2,4,1,0.48223185573570876,-3,6,2,-1.603095087986275,2,3,1,-5,2,1,2,-1,1,5,1,1.179300000011921
15,R_8pQnbYPPeamBQ2J,75,j,2,0,1577.699999988079,University Campus should be a Sanctuary,Hardening schools/Arming teachers,1,-1,1,4,1,0.065166466991312,-3,7,1,-1.603095087986275,1,3,2,-4,3,2,3,-2,2,4,1,1.577699999988079
15,R_8pQnbYPPeamBQ2J,76,j,2,0,2997.300000011921,Hardening schools/Arming teachers,On campus concealed carry,1,1,-3,7,1,-1.603095087986275,2,6,1,0.48223185573570876,-3,2,5,5,-1,5,1,-5,5,-5,1,2.9973000000119208
15,R_8pQnbYPPeamBQ2J,77,j,2,0,2076.7000000476837,On campus concealed carry,Remove public Confederate memorials,-1,-1,2,6,1,0.48223185573570876,3,8,3,0.8992972444801055,-2,-3,-1,1,2,1,2,1,-1,-1,1,2.076700000047684
15,R_8pQnbYPPeamBQ2J,78,f,1,1,1692.800000011921,Remove police from schools,Tuition increases,1,1,-3,2,1,-1.603095087986275,-3,6,2,-1.603095087986275,-3,-3,0,0,-4,0,4,0,0,0,0,1.692800000011921
15,R_8pQnbYPPeamBQ2J,79,f,1,1,1360.699999988079,University Campus should be a Sanctuary,Tuition increases,-1,1,1,4,1,0.065166466991312,-3,6,2,-1.603095087986275,-1,-3,2,4,-2,2,2,2,-2,4,0,1.3606999999880791
15,R_8pQnbYPPeamBQ2J,80,f,1,1,2123.600000023842,Tuition increases,Black Lives Matter,1,-1,-3,6,2,-1.603095087986275,2,6,2,0.48223185573570876,-3,-2,-1,-5,0,1,0,-1,1,-5,0,2.123600000023842
15,R_8pQnbYPPeamBQ2J,81,j,2,0,1730.8999999761581,Tuition increases,Remove police from schools,1,-1,-3,6,2,-1.603095087986275,-3,2,1,-1.603095087986275,-3,3,6,0,-4,6,4,-6,6,0,1,1.730899999976158
15,R_8pQnbYPPeamBQ2J,82,f,1,1,1918.5,Hardening schools/Arming teachers,Abortion rights,-1,1,-3,7,1,-1.603095087986275,2,5,2,0.48223185573570876,3,2,1,-5,2,1,2,1,-1,-5,0,1.9185
15,R_8pQnbYPPeamBQ2J,83,f,1,1,2028.800000011921,University Campus should be a Sanctuary,Mandatory vaccinations,-1,-1,1,4,1,0.065166466991312,3,8,2,0.8992972444801055,-1,-3,2,-2,-4,2,4,2,-2,-2,0,2.028800000011921
15,R_8pQnbYPPeamBQ2J,84,f,1,1,1461.4000000357628,University Campus should be a Sanctuary,Tuition increases,1,1,1,4,1,0.065166466991312,-3,6,2,-1.603095087986275,1,-3,4,4,-2,4,2,4,-4,4,0,1.4614000000357628
15,R_8pQnbYPPeamBQ2J,85,j,2,0,1337,Affirmative action,Tuition increases,-1,-1,1,3,2,0.065166466991312,-3,6,2,-1.603095087986275,-1,3,4,-4,3,4,3,-4,4,4,1,1.337
15,R_8pQnbYPPeamBQ2J,86,f,1,1,1507.8999999761581,Hardening schools/Arming teachers,Abortion rights,-1,-1,-3,7,1,-1.603095087986275,2,5,2,0.48223185573570876,3,-2,5,-5,2,5,2,5,-5,-5,0,1.5078999999761582
15,R_8pQnbYPPeamBQ2J,87,j,2,0,3096.900000035763,Detention of migrant children,Dorms determined by gender identity,1,-1,-3,8,2,-1.603095087986275,0,2,1,-0.3518989217530848,-3,-0,3,3,-6,3,6,-3,3,-3,1,3.0969000000357627
15,R_8pQnbYPPeamBQ2J,88,j,2,0,1617.300000011921,U.S. drone strikes in Afghanistan,Mask mandates,1,1,2,4,1,0.48223185573570876,3,8,3,0.8992972444801055,2,3,1,1,4,1,4,-1,1,-1,1,1.6173000000119209
15,R_8pQnbYPPeamBQ2J,89,j,2,0,1030.0999999642372,Tuition increases,Stop police brutality,1,-1,-3,6,2,-1.603095087986275,3,8,3,0.8992972444801055,-3,-3,0,6,2,0,2,0,0,-6,1,1.0300999999642373
15,R_8pQnbYPPeamBQ2J,90,j,2,0,2478,Increased Gun regulations,Abortion rights,-1,1,3,8,2,0.8992972444801055,2,5,2,0.48223185573570876,-3,2,5,-1,-3,5,3,-5,5,1,1,2.478
15,R_8pQnbYPPeamBQ2J,91,j,2,0,1851.699999988079,Hardening schools/Arming teachers,Mandatory drug tests for welfare recipients,1,1,-3,7,1,-1.603095087986275,-3,8,2,-1.603095087986275,-3,-3,0,0,1,0,1,0,0,0,1,1.851699999988079
15,R_8pQnbYPPeamBQ2J,92,j,2,0,1602.3999999761581,Tuition increases,Abortion rights,1,1,-3,6,2,-1.603095087986275,2,5,2,0.48223185573570876,-3,2,5,5,-1,5,1,-5,5,-5,1,1.6023999999761582
15,R_8pQnbYPPeamBQ2J,93,j,2,0,1921.300000011921,Mandatory trigger warnings,Hardening schools/Arming teachers,-1,-1,0,2,1,-0.3518989217530848,-3,7,1,-1.603095087986275,-0,3,3,-3,5,3,5,-3,3,3,1,1.921300000011921
15,R_8pQnbYPPeamBQ2J,94,j,2,0,4933.300000011921,Hardening schools/Arming teachers,Remove police from schools,1,1,-3,7,1,-1.603095087986275,-3,2,1,-1.603095087986275,-3,-3,0,0,-5,0,5,0,0,0,1,4.933300000011921
15,R_8pQnbYPPeamBQ2J,95,f,1,1,1932.6000000238419,Remove police from schools,Hardening schools/Arming teachers,-1,1,-3,2,1,-1.603095087986275,-3,7,1,-1.603095087986275,3,-3,6,0,-5,6,5,6,-6,0,0,1.932600000023842
15,R_8pQnbYPPeamBQ2J,96,j,2,0,3108.699999988079,Hardening schools/Arming teachers,Defund the police,-1,1,-3,7,1,-1.603095087986275,3,8,3,0.8992972444801055,3,3,0,6,1,0,1,0,0,-6,1,3.108699999988079
15,R_8pQnbYPPeamBQ2J,97,f,1,1,2359.800000011921,Mandatory drug tests for welfare recipients,University Campus should be a Sanctuary,-1,-1,-3,8,2,-1.603095087986275,1,4,1,0.065166466991312,3,-1,4,-4,4,4,4,4,-4,-4,0,2.359800000011921
15,R_8pQnbYPPeamBQ2J,98,f,1,1,1857.1000000238419,Affirmative action,Hardening schools/Arming teachers,1,1,1,3,2,0.065166466991312,-3,7,1,-1.603095087986275,1,-3,4,4,-4,4,4,4,-4,4,0,1.8571000000238418
15,R_8pQnbYPPeamBQ2J,99,f,1,1,838.8000000119209,Hardening schools/Arming teachers,University Campus should be a Sanctuary,-1,-1,-3,7,1,-1.603095087986275,1,4,1,0.065166466991312,3,-1,4,-4,3,4,3,4,-4,-4,0,0.8388000000119209
15,R_8pQnbYPPeamBQ2J,100,j,2,0,1184.5999999642372,Allow alt-right speakers on campus,Affirmative action,1,1,-3,8,1,-1.603095087986275,1,3,2,0.065166466991312,-3,1,4,4,-5,4,5,-4,4,-4,1,1.1845999999642371
18,R_XuqSDM9IDdpxvhL,1,j,2,0,12851.200000047684,Mandatory vaccinations,Mandatory training on sexual consent,-1,-1,3,7,4,0.9596893642797127,3,8,2,0.9596893642797127,-3,-3,0,0,1,0,1,0,0,0,1,12.851200000047683
18,R_XuqSDM9IDdpxvhL,2,j,2,0,11098.899999976158,Mandatory trigger warnings,Mandatory vaccinations,-1,1,2,8,2,0.5466584986403428,3,7,4,0.9596893642797127,-2,3,5,1,-1,5,1,-5,5,-1,1,11.098899999976158
18,R_XuqSDM9IDdpxvhL,3,j,2,0,10570.5,Abortion rights,Mandatory drug tests for welfare recipients,-1,1,3,8,4,0.9596893642797127,-2,5,2,-1.1054649639171374,-3,-2,1,-5,-3,1,3,-1,1,5,1,10.5705
18,R_XuqSDM9IDdpxvhL,4,f,1,1,7262.800000071526,Black Lives Matter,Defund the police,1,-1,1,6,2,0.13362763300097275,-3,7,4,-1.5184958295565074,1,3,-2,4,-1,2,1,-2,2,4,0,7.262800000071525
18,R_XuqSDM9IDdpxvhL,5,j,2,0,7665.199999928474,Defund Planned Parenthood,Dorms determined by gender identity,1,1,-3,8,2,-1.5184958295565074,-3,2,1,-1.5184958295565074,-3,-3,0,0,-6,0,6,0,0,0,1,7.665199999928475
18,R_XuqSDM9IDdpxvhL,6,f,1,1,5533,Mandatory vaccinations,Tuition increases,1,-1,3,7,4,0.9596893642797127,-3,4,2,-1.5184958295565074,3,3,0,6,3,0,3,0,0,6,0,5.533
18,R_XuqSDM9IDdpxvhL,7,f,1,1,6546.100000023842,University Campus should be a Sanctuary,Defund the police,1,-1,-1,3,1,-0.6924340982777674,-3,7,4,-1.5184958295565074,-1,3,-4,2,-4,4,4,-4,4,2,0,6.546100000023842
18,R_XuqSDM9IDdpxvhL,8,f,1,1,3976.6999999284744,Abolishing private prisons,Defund the police,1,-1,2,4,2,0.5466584986403428,-3,7,4,-1.5184958295565074,2,3,-1,5,-3,1,3,-1,1,5,0,3.9766999999284742
18,R_XuqSDM9IDdpxvhL,9,f,1,1,5657.899999976158,Legalization of marijuana,Safe injection locations,1,1,3,7,4,0.9596893642797127,2,7,1,0.5466584986403428,3,2,1,1,0,1,0,1,-1,1,0,5.657899999976158
18,R_XuqSDM9IDdpxvhL,10,f,1,1,4025.5999999046326,Mandatory vaccinations,Build southern border wall,1,-1,3,7,4,0.9596893642797127,3,4,4,0.9596893642797127,3,-3,6,0,3,6,3,6,-6,0,0,4.025599999904633
18,R_XuqSDM9IDdpxvhL,11,f,1,1,3434.100000023842,Mandatory vaccinations,Student worker unionization,1,1,3,7,4,0.9596893642797127,2,8,1,0.5466584986403428,3,2,1,1,-1,1,1,1,-1,1,0,3.4341000000238417
18,R_XuqSDM9IDdpxvhL,12,j,2,0,6002.699999928474,Cuts to National Parks budget,Abolishing private prisons,1,1,-3,7,2,-1.5184958295565074,2,4,2,0.5466584986403428,-3,2,5,5,-3,5,3,-5,5,-5,1,6.002699999928474
18,R_XuqSDM9IDdpxvhL,13,f,1,1,5344.100000023842,Stop police brutality,Student worker unionization,1,1,3,8,4,0.9596893642797127,2,8,1,0.5466584986403428,3,2,1,1,0,1,0,1,-1,1,0,5.3441000000238414
18,R_XuqSDM9IDdpxvhL,14,f,1,1,5054.299999952316,Remove public Confederate memorials,Black Lives Matter,-1,1,3,8,4,0.9596893642797127,1,6,2,0.13362763300097275,-3,1,-4,2,2,4,2,-4,4,2,0,5.054299999952316
18,R_XuqSDM9IDdpxvhL,15,j,2,0,2260.5,Dorms determined by gender identity,Mandatory vaccinations,-1,1,-3,2,1,-1.5184958295565074,3,7,4,0.9596893642797127,3,3,0,6,5,0,5,0,0,-6,1,2.2605
18,R_XuqSDM9IDdpxvhL,16,j,2,0,4991,Mask mandates,Mandatory vaccinations,-1,1,3,6,4,0.9596893642797127,3,7,4,0.9596893642797127,-3,3,6,0,1,6,1,-6,6,0,1,4.991
18,R_XuqSDM9IDdpxvhL,17,j,2,0,8372.700000047684,Abolishing private prisons,Religious exemptions for discrimination laws,1,-1,2,4,2,0.5466584986403428,-3,8,2,-1.5184958295565074,2,3,1,-5,4,1,4,-1,1,5,1,8.372700000047685
18,R_XuqSDM9IDdpxvhL,18,j,2,0,4766.400000095367,Mandatory vaccinations,Increased Gun regulations,-1,-1,3,7,4,0.9596893642797127,3,5,4,0.9596893642797127,-3,-3,0,0,-2,0,2,0,0,0,1,4.766400000095367
18,R_XuqSDM9IDdpxvhL,19,j,2,0,6578.899999976158,Defund the police,Dorms determined by gender identity,-1,1,-3,7,4,-1.5184958295565074,-3,2,1,-1.5184958295565074,3,-3,-6,0,-5,6,5,6,-6,0,1,6.578899999976158
18,R_XuqSDM9IDdpxvhL,20,f,1,1,13254.5,Mandatory drug tests for welfare recipients,Stop police brutality,-1,-1,-2,5,2,-1.1054649639171374,3,8,4,0.9596893642797127,2,-3,5,-5,-3,5,3,5,-5,-5,0,13.2545
18,R_XuqSDM9IDdpxvhL,21,j,2,0,5380.800000071526,Mandatory vaccinations,Mandatory trigger warnings,-1,-1,3,7,4,0.9596893642797127,2,8,2,0.5466584986403428,-3,-2,1,-1,1,1,1,-1,1,1,1,5.380800000071526
18,R_XuqSDM9IDdpxvhL,22,j,2,0,5698.699999928474,Allow alt-right speakers on campus,Mandatory training on sexual consent,-1,1,1,1,1,0.13362763300097275,3,8,2,0.9596893642797127,-1,3,4,2,7,4,7,-4,4,-2,1,5.698699999928475
18,R_XuqSDM9IDdpxvhL,23,j,2,0,8279.600000023842,Detention of migrant children,Recognize Jerusalem as capital of Israel,1,-1,-3,8,2,-1.5184958295565074,1,1,1,0.13362763300097275,-3,-1,2,4,-7,2,7,-2,2,-4,1,8.279600000023843
18,R_XuqSDM9IDdpxvhL,24,j,2,0,4850.300000071526,Defund Planned Parenthood,Student worker unionization,1,1,-3,8,2,-1.5184958295565074,2,8,1,0.5466584986403428,-3,2,5,5,0,5,0,-5,5,-5,1,4.850300000071526
18,R_XuqSDM9IDdpxvhL,25,f,1,1,3651.600000023842,Mandatory training on sexual consent,Dorms determined by gender identity,1,-1,3,8,2,0.9596893642797127,-3,2,1,-1.5184958295565074,3,3,0,6,6,0,6,0,0,6,0,3.651600000023842
18,R_XuqSDM9IDdpxvhL,26,j,2,0,11194.899999976158,Mandatory vaccinations,Mask mandates,-1,-1,3,7,4,0.9596893642797127,3,6,4,0.9596893642797127,-3,-3,0,0,-1,0,1,0,0,0,1,11.194899999976158
18,R_XuqSDM9IDdpxvhL,27,j,2,0,9278.899999976158,Defund the police,Build southern border wall,1,-1,-3,7,4,-1.5184958295565074,3,4,4,0.9596893642797127,-3,-3,0,6,-3,0,3,0,0,-6,1,9.278899999976158
18,R_XuqSDM9IDdpxvhL,28,f,1,1,13236.699999928474,Mandatory drug tests for welfare recipients,Legalization of marijuana,-1,-1,-2,5,2,-1.1054649639171374,3,7,4,0.9596893642797127,2,-3,5,-5,-2,5,2,5,-5,-5,0,13.236699999928474
18,R_XuqSDM9IDdpxvhL,29,f,1,1,6397.899999976158,Safe injection locations,Detention of migrant children,1,-1,2,7,1,0.5466584986403428,-3,8,2,-1.5184958295565074,2,3,-1,5,-1,1,1,-1,1,5,0,6.3978999999761585
18,R_XuqSDM9IDdpxvhL,30,f,1,1,8206.899999976158,Abortion rights,Increased Gun regulations,1,-1,3,8,4,0.9596893642797127,3,5,4,0.9596893642797127,3,-3,6,0,3,6,3,6,-6,0,0,8.206899999976159
18,R_XuqSDM9IDdpxvhL,31,f,1,1,4484.700000047684,Affirmative action,"Boycott, Divest, and Sanction Israel",1,1,3,8,4,0.9596893642797127,1,8,2,0.13362763300097275,3,1,2,2,0,2,0,2,-2,2,0,4.484700000047684
18,R_XuqSDM9IDdpxvhL,32,j,2,0,7861.400000095367,Religious exemptions for discrimination laws,Remove Christopher Columbus statues,1,-1,-3,8,2,-1.5184958295565074,-1,2,1,-0.6924340982777674,-3,1,4,2,-6,4,6,-4,4,-2,1,7.861400000095367
18,R_XuqSDM9IDdpxvhL,33,j,2,0,2602,Safe injection locations,Mandatory vaccinations,-1,1,2,7,1,0.5466584986403428,3,7,4,0.9596893642797127,-2,3,5,1,0,5,0,-5,5,-1,1,2.602
18,R_XuqSDM9IDdpxvhL,34,j,2,0,4067.3000000715256,"Boycott, Divest, and Sanction Israel",Affirmative action,-1,1,1,8,2,0.13362763300097275,3,8,4,0.9596893642797127,-1,3,4,2,0,4,0,-4,4,-2,1,4.067300000071525
18,R_XuqSDM9IDdpxvhL,35,j,2,0,8269.5,Mandatory training on sexual consent,University Campus should be a Sanctuary,-1,1,3,8,2,0.9596893642797127,-1,3,1,-0.6924340982777674,-3,-1,2,-4,-5,2,5,-2,2,4,1,8.2695
18,R_XuqSDM9IDdpxvhL,36,j,2,0,3784.100000023842,Defund the police,Safe injection locations,1,1,-3,7,4,-1.5184958295565074,2,7,1,0.5466584986403428,-3,2,5,5,0,5,0,-5,5,-5,1,3.784100000023842
18,R_XuqSDM9IDdpxvhL,37,f,1,1,5680.099999904633,Climate change legislation,Cuts to National Parks budget,1,1,3,8,4,0.9596893642797127,-3,7,2,-1.5184958295565074,3,-3,6,6,1,6,1,6,-6,6,0,5.680099999904632
18,R_XuqSDM9IDdpxvhL,38,f,1,1,7062.200000047684,Legalization of marijuana,Detention of migrant children,1,-1,3,7,4,0.9596893642797127,-3,8,2,-1.5184958295565074,3,3,0,6,-1,0,1,0,0,6,0,7.0622000000476834
18,R_XuqSDM9IDdpxvhL,39,f,1,1,3673,Mandatory vaccinations,U.S. drone strikes in Afghanistan,1,-1,3,7,4,0.9596893642797127,1,2,3,0.13362763300097275,3,-1,4,2,5,4,5,4,-4,2,0,3.673
18,R_XuqSDM9IDdpxvhL,40,j,2,0,4556.899999976158,Raise the minimum wage,Mask mandates,-1,1,3,8,4,0.9596893642797127,3,6,4,0.9596893642797127,-3,3,6,0,-2,6,2,-6,6,0,1,4.556899999976158
18,R_XuqSDM9IDdpxvhL,41,j,2,0,10453.600000023842,Abolishing private prisons,Remove public Confederate memorials,-1,1,2,4,2,0.5466584986403428,3,8,4,0.9596893642797127,-2,3,5,1,4,5,4,-5,5,-1,1,10.453600000023842
18,R_XuqSDM9IDdpxvhL,42,j,2,0,3212.8000000715256,Abolishing private prisons,Legalization of marijuana,-1,1,2,4,2,0.5466584986403428,3,7,4,0.9596893642797127,-2,3,5,1,3,5,3,-5,5,-1,1,3.2128000000715256
18,R_XuqSDM9IDdpxvhL,43,f,1,1,2718.2000000476837,Climate change legislation,Mask mandates,1,-1,3,8,4,0.9596893642797127,3,6,4,0.9596893642797127,3,-3,6,0,2,6,2,6,-6,0,0,2.7182000000476836
18,R_XuqSDM9IDdpxvhL,44,f,1,1,3163.100000023842,Mask mandates,Defund the police,1,1,3,6,4,0.9596893642797127,-3,7,4,-1.5184958295565074,3,-3,6,6,-1,6,1,6,-6,6,0,3.163100000023842
18,R_XuqSDM9IDdpxvhL,45,f,1,1,2681.600000023842,Mandatory vaccinations,"Boycott, Divest, and Sanction Israel",1,-1,3,7,4,0.9596893642797127,1,8,2,0.13362763300097275,3,-1,4,2,-1,4,1,4,-4,2,0,2.681600000023842
18,R_XuqSDM9IDdpxvhL,46,j,2,0,4724,Legalization of marijuana,Mask mandates,1,1,3,7,4,0.9596893642797127,3,6,4,0.9596893642797127,3,3,0,0,-1,0,1,0,0,0,1,4.724
18,R_XuqSDM9IDdpxvhL,47,j,2,0,3193.4000000953674,Build southern border wall,Affirmative action,1,1,3,4,4,0.9596893642797127,3,8,4,0.9596893642797127,3,3,0,0,4,0,4,0,0,0,1,3.1934000000953673
18,R_XuqSDM9IDdpxvhL,48,f,1,1,4124.5,Increased Gun regulations,Cuts to National Parks budget,1,-1,3,5,4,0.9596893642797127,-3,7,2,-1.5184958295565074,3,3,0,6,-2,0,2,0,0,6,0,4.1245
18,R_XuqSDM9IDdpxvhL,49,j,2,0,5447.299999952316,Safe injection locations,Stop police brutality,-1,-1,2,7,1,0.5466584986403428,3,8,4,0.9596893642797127,-2,-3,-1,1,1,1,1,1,-1,-1,1,5.447299999952317
18,R_XuqSDM9IDdpxvhL,50,f,1,1,4165.199999928474,Mandatory vaccinations,Cuts to National Parks budget,1,1,3,7,4,0.9596893642797127,-3,7,2,-1.5184958295565074,3,-3,6,6,0,6,0,6,-6,6,0,4.165199999928475
18,R_XuqSDM9IDdpxvhL,51,j,2,0,4875,U.S. drone strikes in Afghanistan,Legalization of marijuana,1,1,1,2,3,0.13362763300097275,3,7,4,0.9596893642797127,1,3,2,2,5,2,5,-2,2,-2,1,4.875
18,R_XuqSDM9IDdpxvhL,52,j,2,0,3906.899999976158,Safe injection locations,Mandatory training on sexual consent,-1,1,2,7,1,0.5466584986403428,3,8,2,0.9596893642797127,-2,3,5,1,1,5,1,-5,5,-1,1,3.906899999976158
18,R_XuqSDM9IDdpxvhL,53,j,2,0,5324.100000023842,Affirmative action,"Boycott, Divest, and Sanction Israel",-1,1,3,8,4,0.9596893642797127,1,8,2,0.13362763300097275,-3,1,4,-2,0,4,0,-4,4,2,1,5.324100000023842
18,R_XuqSDM9IDdpxvhL,54,j,2,0,4956.600000023842,Abortion rights,Cuts to National Parks budget,-1,-1,3,8,4,0.9596893642797127,-3,7,2,-1.5184958295565074,-3,3,6,-6,-1,6,1,-6,6,6,1,4.956600000023842
18,R_XuqSDM9IDdpxvhL,55,j,2,0,12115.199999928474,Detention of migrant children,Mandatory drug tests for welfare recipients,-1,-1,-3,8,2,-1.5184958295565074,-2,5,2,-1.1054649639171374,3,2,-1,1,-3,1,3,1,-1,-1,1,12.115199999928475
18,R_XuqSDM9IDdpxvhL,56,f,1,1,7775.099999904633,Cuts to National Parks budget,Recognize Jerusalem as capital of Israel,-1,1,-3,7,2,-1.5184958295565074,1,1,1,0.13362763300097275,3,1,2,-4,6,2,6,2,-2,-4,0,7.775099999904633
18,R_XuqSDM9IDdpxvhL,57,j,2,0,2322.3000000715256,University Campus should be a Sanctuary,Legalization of marijuana,-1,1,-1,3,1,-0.6924340982777674,3,7,4,0.9596893642797127,1,3,2,4,4,2,4,-2,2,-4,1,2.3223000000715257
18,R_XuqSDM9IDdpxvhL,58,j,2,0,2472,Mandatory trigger warnings,Climate change legislation,-1,1,2,8,2,0.5466584986403428,3,8,4,0.9596893642797127,-2,3,5,1,0,5,0,-5,5,-1,1,2.472
18,R_XuqSDM9IDdpxvhL,59,j,2,0,2658,Gun-free campus police,Affirmative action,-1,1,1,3,1,0.13362763300097275,3,8,4,0.9596893642797127,-1,3,4,2,5,4,5,-4,4,-2,1,2.658
18,R_XuqSDM9IDdpxvhL,60,f,1,1,6933.900000095367,"Boycott, Divest, and Sanction Israel",Climate change legislation,-1,-1,1,8,2,0.13362763300097275,3,8,4,0.9596893642797127,-1,-3,2,-2,0,2,0,2,-2,-2,0,6.933900000095368
18,R_XuqSDM9IDdpxvhL,61,f,1,1,3271.1999999284744,Raise the minimum wage,Gun-free campus police,1,1,3,8,4,0.9596893642797127,1,3,1,0.13362763300097275,3,1,2,2,5,2,5,2,-2,2,0,3.2711999999284744
18,R_XuqSDM9IDdpxvhL,62,j,2,0,2329.7999999523163,Mandatory drug tests for welfare recipients,Legalization of marijuana,1,1,-2,5,2,-1.1054649639171374,3,7,4,0.9596893642797127,-2,3,5,5,2,5,2,-5,5,-5,1,2.3297999999523165
18,R_XuqSDM9IDdpxvhL,63,j,2,0,11241.600000023842,Dorms determined by gender identity,Detention of migrant children,1,-1,-3,2,1,-1.5184958295565074,-3,8,2,-1.5184958295565074,-3,3,6,0,6,6,6,-6,6,0,1,11.241600000023842
18,R_XuqSDM9IDdpxvhL,64,f,1,1,4438.900000095367,Increased Gun regulations,Abortion rights,-1,-1,3,5,4,0.9596893642797127,3,8,4,0.9596893642797127,-3,-3,0,0,-3,0,3,0,0,0,0,4.438900000095368
18,R_XuqSDM9IDdpxvhL,65,f,1,1,5136.100000023842,Dorms determined by gender identity,Mandatory vaccinations,1,-1,-3,2,1,-1.5184958295565074,3,7,4,0.9596893642797127,-3,-3,0,-6,-5,0,5,0,0,-6,0,5.136100000023842
18,R_XuqSDM9IDdpxvhL,66,f,1,1,9744.799999952316,War on Drugs,Black Lives Matter,-1,1,-3,8,4,-1.5184958295565074,1,6,2,0.13362763300097275,3,1,2,-4,2,2,2,2,-2,-4,0,9.744799999952317
18,R_XuqSDM9IDdpxvhL,67,f,1,1,4212.899999976158,"Boycott, Divest, and Sanction Israel",Defund the police,1,-1,1,8,2,0.13362763300097275,-3,7,4,-1.5184958295565074,1,3,-2,4,1,2,1,-2,2,4,0,4.212899999976158
18,R_XuqSDM9IDdpxvhL,68,j,2,0,9504.100000023842,Increased Gun regulations,Cuts to National Parks budget,-1,-1,3,5,4,0.9596893642797127,-3,7,2,-1.5184958295565074,-3,3,6,-6,2,6,2,-6,6,6,1,9.504100000023842
18,R_XuqSDM9IDdpxvhL,69,j,2,0,7230.399999976158,Tuition increases,Defund Planned Parenthood,1,-1,-3,4,2,-1.5184958295565074,-3,8,2,-1.5184958295565074,-3,3,6,0,4,6,4,-6,6,0,1,7.230399999976158
18,R_XuqSDM9IDdpxvhL,70,f,1,1,3625.7999999523163,Raise the minimum wage,Mandatory drug tests for welfare recipients,1,1,3,8,4,0.9596893642797127,-2,5,2,-1.1054649639171374,3,-2,5,5,3,5,3,5,-5,5,0,3.6257999999523163
18,R_XuqSDM9IDdpxvhL,71,f,1,1,7926.600000023842,Mandatory drug tests for welfare recipients,Cuts to National Parks budget,-1,-1,-2,5,2,-1.1054649639171374,-3,7,2,-1.5184958295565074,2,3,-1,1,-2,1,2,-1,1,1,0,7.926600000023842
18,R_XuqSDM9IDdpxvhL,72,f,1,1,6065.299999952316,Safe injection locations,Mandatory vaccinations,-1,-1,2,7,1,0.5466584986403428,3,7,4,0.9596893642797127,-2,-3,1,-1,0,1,0,1,-1,-1,0,6.065299999952316
18,R_XuqSDM9IDdpxvhL,73,f,1,1,10426.5,Abolishing private prisons,Cuts to National Parks budget,-1,1,2,4,2,0.5466584986403428,-3,7,2,-1.5184958295565074,-2,-3,1,5,-3,1,3,1,-1,5,0,10.4265
18,R_XuqSDM9IDdpxvhL,74,j,2,0,2776.600000023842,Black Lives Matter,Mandatory vaccinations,-1,1,1,6,2,0.13362763300097275,3,7,4,0.9596893642797127,-1,3,4,2,1,4,1,-4,4,-2,1,2.776600000023842
18,R_XuqSDM9IDdpxvhL,75,j,2,0,2514,Mandatory vaccinations,Increased Gun regulations,-1,1,3,7,4,0.9596893642797127,3,5,4,0.9596893642797127,-3,3,6,0,-2,6,2,-6,6,0,1,2.514
18,R_XuqSDM9IDdpxvhL,76,j,2,0,3097.8000000715256,Climate change legislation,Build southern border wall,-1,1,3,8,4,0.9596893642797127,3,4,4,0.9596893642797127,-3,3,6,0,-4,6,4,-6,6,0,1,3.097800000071526
18,R_XuqSDM9IDdpxvhL,77,j,2,0,3055.2999999523163,Remove public Confederate memorials,Raise the minimum wage,-1,1,3,8,4,0.9596893642797127,3,8,4,0.9596893642797127,-3,3,6,0,0,6,0,-6,6,0,1,3.0552999999523163
18,R_XuqSDM9IDdpxvhL,78,f,1,1,6201.199999928474,Recognize Jerusalem as capital of Israel,Mandatory training on sexual consent,1,-1,1,1,1,0.13362763300097275,3,8,2,0.9596893642797127,1,-3,4,-2,-7,4,7,4,-4,-2,0,6.201199999928474
18,R_XuqSDM9IDdpxvhL,79,j,2,0,2859.6999999284744,Black Lives Matter,Raise the minimum wage,-1,1,1,6,2,0.13362763300097275,3,8,4,0.9596893642797127,-1,3,4,2,2,4,2,-4,4,-2,1,2.8596999999284742
18,R_XuqSDM9IDdpxvhL,80,f,1,1,5965.200000047684,Abolishing private prisons,Climate change legislation,1,-1,2,4,2,0.5466584986403428,3,8,4,0.9596893642797127,2,-3,5,-1,-4,5,4,5,-5,-1,0,5.965200000047684
18,R_XuqSDM9IDdpxvhL,81,j,2,0,7103.699999928474,War on Drugs,Allow alt-right speakers on campus,-1,1,-3,8,4,-1.5184958295565074,1,1,1,0.13362763300097275,3,1,-2,4,-7,2,7,2,-2,-4,1,7.103699999928474
18,R_XuqSDM9IDdpxvhL,82,j,2,0,2897.8000000715256,War on Drugs,Mask mandates,-1,1,-3,8,4,-1.5184958295565074,3,6,4,0.9596893642797127,3,3,0,6,-2,0,2,0,0,-6,1,2.8978000000715256
18,R_XuqSDM9IDdpxvhL,83,f,1,1,7479.199999928474,Student worker unionization,Stop police brutality,-1,-1,2,8,1,0.5466584986403428,3,8,4,0.9596893642797127,-2,-3,1,-1,0,1,0,1,-1,-1,0,7.479199999928475
18,R_XuqSDM9IDdpxvhL,84,j,2,0,3112.3000000715256,Affirmative action,Safe injection locations,-1,1,3,8,4,0.9596893642797127,2,7,1,0.5466584986403428,-3,2,5,-1,-1,5,1,-5,5,1,1,3.1123000000715257
18,R_XuqSDM9IDdpxvhL,85,f,1,1,5363.199999928474,Mandatory drug tests for welfare recipients,Cuts to National Parks budget,1,1,-2,5,2,-1.1054649639171374,-3,7,2,-1.5184958295565074,-2,-3,1,1,-2,1,2,1,-1,1,0,5.363199999928474
18,R_XuqSDM9IDdpxvhL,86,f,1,1,5298.199999928474,Tuition increases,Cuts to National Parks budget,-1,1,-3,4,2,-1.5184958295565074,-3,7,2,-1.5184958295565074,3,-3,6,0,-3,6,3,6,-6,0,0,5.298199999928475
18,R_XuqSDM9IDdpxvhL,87,f,1,1,5454.100000023842,Dorms determined by gender identity,Religious exemptions for discrimination laws,-1,1,-3,2,1,-1.5184958295565074,-3,8,2,-1.5184958295565074,3,-3,6,0,-6,6,6,6,-6,0,0,5.454100000023842
18,R_XuqSDM9IDdpxvhL,88,j,2,0,6753.200000047684,Remove Christopher Columbus statues,Defund Planned Parenthood,1,-1,-1,2,1,-0.6924340982777674,-3,8,2,-1.5184958295565074,-1,3,4,-2,6,4,6,-4,4,2,1,6.753200000047683
18,R_XuqSDM9IDdpxvhL,89,f,1,1,6002.700000047684,Increased Gun regulations,Stop police brutality,1,-1,3,5,4,0.9596893642797127,3,8,4,0.9596893642797127,3,-3,6,0,-3,6,3,6,-6,0,0,6.002700000047684
18,R_XuqSDM9IDdpxvhL,90,f,1,1,6316.699999928474,Tuition increases,Climate change legislation,1,-1,-3,4,2,-1.5184958295565074,3,8,4,0.9596893642797127,-3,-3,0,-6,-4,0,4,0,0,-6,0,6.316699999928474
18,R_XuqSDM9IDdpxvhL,91,f,1,1,8213.199999928474,Remove public Confederate memorials,Abolishing private prisons,-1,-1,3,8,4,0.9596893642797127,2,4,2,0.5466584986403428,-3,-2,-1,1,4,1,4,-1,1,1,0,8.213199999928474
18,R_XuqSDM9IDdpxvhL,92,j,2,0,9637.300000071526,Increased Gun regulations,Defund Planned Parenthood,1,-1,3,5,4,0.9596893642797127,-3,8,2,-1.5184958295565074,3,3,0,-6,3,0,3,0,0,6,1,9.637300000071525
18,R_XuqSDM9IDdpxvhL,93,f,1,1,5442,Mandatory training on sexual consent,Mask mandates,-1,-1,3,8,2,0.9596893642797127,3,6,4,0.9596893642797127,-3,-3,0,0,2,0,2,0,0,0,0,5.442
18,R_XuqSDM9IDdpxvhL,94,f,1,1,4682,Recognize Jerusalem as capital of Israel,Defund the police,-1,-1,1,1,1,0.13362763300097275,-3,7,4,-1.5184958295565074,-1,3,-4,4,-6,4,6,-4,4,4,0,4.682
18,R_XuqSDM9IDdpxvhL,95,j,2,0,5746.100000023842,Legalization of marijuana,Dorms determined by gender identity,-1,-1,3,7,4,0.9596893642797127,-3,2,1,-1.5184958295565074,-3,3,6,-6,-5,6,5,-6,6,6,1,5.746100000023842
18,R_XuqSDM9IDdpxvhL,96,f,1,1,8780.299999952316,U.S. drone strikes in Afghanistan,Raise the minimum wage,-1,-1,1,2,3,0.13362763300097275,3,8,4,0.9596893642797127,-1,-3,2,-2,-6,2,6,2,-2,-2,0,8.780299999952316
18,R_XuqSDM9IDdpxvhL,97,f,1,1,10484.399999976158,Religious exemptions for discrimination laws,Black Lives Matter,1,-1,-3,8,2,-1.5184958295565074,1,6,2,0.13362763300097275,-3,-1,-2,-4,2,2,2,-2,2,-4,0,10.484399999976159
18,R_XuqSDM9IDdpxvhL,98,f,1,1,6229.399999976158,Gun-free campus police,Raise the minimum wage,1,-1,1,3,1,0.13362763300097275,3,8,4,0.9596893642797127,1,-3,4,-2,-5,4,5,4,-4,-2,0,6.229399999976158
18,R_XuqSDM9IDdpxvhL,99,j,2,0,4901.899999976158,Remove Christopher Columbus statues,Climate change legislation,-1,1,-1,2,1,-0.6924340982777674,3,8,4,0.9596893642797127,1,3,2,4,6,2,6,-2,2,-4,1,4.901899999976158
18,R_XuqSDM9IDdpxvhL,100,f,1,1,5257.700000047684,Student worker unionization,Mandatory vaccinations,1,-1,2,8,1,0.5466584986403428,3,7,4,0.9596893642797127,2,-3,5,-1,1,5,1,5,-5,-1,0,5.2577000000476835
4,R_1nVYSEciL6sPzAO,1,j,2,0,5226,Abolishing private prisons,Ban on ethnic Halloween costumes,-1,-1,3,7,3,1.6834355419440914,-2,0,1,-0.7214723751188964,-3,2,5,-5,-7,5,7,-5,5,5,1,5.226
4,R_1nVYSEciL6sPzAO,2,f,1,1,8938,U.S. drone strikes in Afghanistan,Abolishing private prisons,1,-1,-1,0,2,-0.24049079170629878,3,7,3,1.6834355419440914,-1,-3,2,-4,-7,2,7,2,-2,-4,0,8.938
4,R_1nVYSEciL6sPzAO,3,j,2,0,6295,Build southern border wall,Abolishing private prisons,-1,-1,2,0,4,1.202453958531494,3,7,3,1.6834355419440914,-2,-3,-1,1,7,1,7,1,-1,-1,1,6.295
4,R_1nVYSEciL6sPzAO,4,j,2,0,2669,Abolishing private prisons,Mandatory trigger warnings,-1,-1,3,7,3,1.6834355419440914,-3,0,2,-1.202453958531494,-3,3,6,-6,-7,6,7,-6,6,6,1,2.669
4,R_1nVYSEciL6sPzAO,5,f,1,1,2259,Defund Planned Parenthood,Black Lives Matter,1,1,2,7,3,1.202453958531494,-3,4,3,-1.202453958531494,2,-3,5,5,3,5,3,5,-5,5,0,2.259
4,R_1nVYSEciL6sPzAO,6,f,1,1,2476,Mandatory vaccinations,Affirmative action,-1,-1,-3,8,4,-1.202453958531494,-3,4,4,-1.202453958531494,3,3,0,0,4,0,4,0,0,0,0,2.476
4,R_1nVYSEciL6sPzAO,7,j,2,0,2865,Recognize Jerusalem as capital of Israel,Abolishing private prisons,-1,1,0,0,3,0.24049079170629878,3,7,3,1.6834355419440914,-0,3,3,3,7,3,7,-3,3,-3,1,2.865
4,R_1nVYSEciL6sPzAO,8,f,1,1,3655,Abolishing private prisons,Stop police brutality,1,-1,3,7,3,1.6834355419440914,2,4,3,1.202453958531494,3,-2,5,1,3,5,3,5,-5,1,0,3.655
4,R_1nVYSEciL6sPzAO,9,f,1,1,3490,Abolishing fraternities,Allow alt-right speakers on campus,1,-1,0,0,1,0.24049079170629878,3,8,3,1.6834355419440914,0,-3,3,-3,-8,3,8,3,-3,-3,0,3.49
4,R_1nVYSEciL6sPzAO,10,f,1,1,1956,Abolishing private prisons,Black Lives Matter,1,1,3,7,3,1.6834355419440914,-3,4,3,-1.202453958531494,3,-3,6,6,3,6,3,6,-6,6,0,1.956
4,R_1nVYSEciL6sPzAO,11,j,2,0,2758,Raise the minimum wage,Abolishing private prisons,-1,1,-2,0,4,-0.7214723751188964,3,7,3,1.6834355419440914,2,3,1,5,7,1,7,-1,1,-5,1,2.758
4,R_1nVYSEciL6sPzAO,12,f,1,1,2787,Increased Gun regulations,Stop police brutality,-1,-1,-3,0,4,-1.202453958531494,2,4,3,1.202453958531494,3,-2,5,-5,-4,5,4,5,-5,-5,0,2.787
4,R_1nVYSEciL6sPzAO,13,f,1,1,5854,Abolishing private prisons,Expel students with white nationlist views,-1,1,3,7,3,1.6834355419440914,-3,8,1,-1.202453958531494,-3,-3,0,6,-1,0,1,0,0,6,0,5.854
4,R_1nVYSEciL6sPzAO,14,j,2,0,3075,Abolishing private prisons,U.S. drone strikes in Afghanistan,-1,-1,3,7,3,1.6834355419440914,-1,0,2,-0.24049079170629878,-3,1,4,-4,-7,4,7,-4,4,4,1,3.075
4,R_1nVYSEciL6sPzAO,15,j,2,0,1774,Black Lives Matter,Black Lives Matter,1,-1,-3,4,3,-1.202453958531494,-3,4,3,-1.202453958531494,-3,3,6,0,0,6,0,-6,6,0,1,1.774
4,R_1nVYSEciL6sPzAO,16,j,2,0,2839,Abolishing private prisons,Stop police brutality,-1,1,3,7,3,1.6834355419440914,2,4,3,1.202453958531494,-3,2,5,-1,-3,5,3,-5,5,1,1,2.839
4,R_1nVYSEciL6sPzAO,17,f,1,1,4335,Mandatory drug tests for welfare recipients,Lift COVID lockdowns,-1,-1,-2,0,3,-0.7214723751188964,3,8,4,1.6834355419440914,2,-3,5,-5,-8,5,8,5,-5,-5,0,4.335
4,R_1nVYSEciL6sPzAO,18,j,2,0,2246,Mandatory vaccinations,U.S. drone strikes in Afghanistan,1,-1,-3,8,4,-1.202453958531494,-1,0,2,-0.24049079170629878,-3,1,4,2,-8,4,8,-4,4,-2,1,2.246
4,R_1nVYSEciL6sPzAO,19,j,2,0,3610,U.S. drone strikes in Afghanistan,Affirmative action,-1,-1,-1,0,2,-0.24049079170629878,-3,4,4,-1.202453958531494,1,3,2,-2,4,2,4,-2,2,2,1,3.61
4,R_1nVYSEciL6sPzAO,20,j,2,0,1937,Stop police brutality,Abolishing private prisons,1,1,2,4,3,1.202453958531494,3,7,3,1.6834355419440914,2,3,1,1,3,1,3,-1,1,-1,1,1.937
4,R_1nVYSEciL6sPzAO,21,f,1,1,2083,Climate change legislation,Abolishing private prisons,-1,1,-3,0,4,-1.202453958531494,3,7,3,1.6834355419440914,3,3,0,-6,-7,0,7,0,0,-6,0,2.083
4,R_1nVYSEciL6sPzAO,22,j,2,0,1972,Black Lives Matter,Defund Planned Parenthood,-1,-1,-3,4,3,-1.202453958531494,2,7,3,1.202453958531494,3,-2,-5,5,3,5,3,5,-5,-5,1,1.972
4,R_1nVYSEciL6sPzAO,23,f,1,1,5552,Mandatory trigger warnings,Defund Planned Parenthood,-1,1,-3,0,2,-1.202453958531494,2,7,3,1.202453958531494,3,2,1,-5,-7,1,7,1,-1,-5,0,5.552
4,R_1nVYSEciL6sPzAO,24,f,1,1,2695,Defund Planned Parenthood,Black Lives Matter,1,-1,2,7,3,1.202453958531494,-3,4,3,-1.202453958531494,2,3,-1,5,3,1,3,-1,1,5,0,2.695
4,R_1nVYSEciL6sPzAO,25,j,2,0,2159,Ban on ethnic Halloween costumes,Affirmative action,-1,-1,-2,0,1,-0.7214723751188964,-3,4,4,-1.202453958531494,2,3,1,-1,4,1,4,-1,1,1,1,2.159
4,R_1nVYSEciL6sPzAO,26,f,1,1,2120,Ban on research with animals,Black Lives Matter,1,-1,1,4,3,0.7214723751188964,-3,4,3,-1.202453958531494,1,3,-2,4,0,2,0,-2,2,4,0,2.12
4,R_1nVYSEciL6sPzAO,27,j,2,0,4679,Lift COVID lockdowns,Stop police brutality,-1,-1,3,8,4,1.6834355419440914,2,4,3,1.202453958531494,-3,-2,1,-1,-4,1,4,-1,1,1,1,4.679
4,R_1nVYSEciL6sPzAO,28,j,2,0,2940,Bathrooms restricted based on biological sex,Mandatory training on sexual consent,-1,-1,3,4,3,1.6834355419440914,0,0,2,0.24049079170629878,-3,-0,3,-3,-4,3,4,-3,3,3,1,2.94
4,R_1nVYSEciL6sPzAO,29,f,1,1,2432,U.S. drone strikes in Afghanistan,Black Lives Matter,-1,1,-1,0,2,-0.24049079170629878,-3,4,3,-1.202453958531494,1,-3,4,2,-4,4,4,4,-4,2,0,2.432
4,R_1nVYSEciL6sPzAO,30,f,1,1,1838,Abolishing private prisons,Ban on research with animals,1,-1,3,7,3,1.6834355419440914,1,4,3,0.7214723751188964,3,-1,4,2,3,4,3,4,-4,2,0,1.838
4,R_1nVYSEciL6sPzAO,31,j,2,0,6246,Bathrooms restricted based on biological sex,Stop police brutality,-1,-1,3,4,3,1.6834355419440914,2,4,3,1.202453958531494,-3,-2,1,-1,0,1,0,-1,1,1,1,6.246
4,R_1nVYSEciL6sPzAO,32,j,2,0,2066,Abolishing private prisons,Expel students with white nationlist views,-1,-1,3,7,3,1.6834355419440914,-3,8,1,-1.202453958531494,-3,3,6,-6,1,6,1,-6,6,6,1,2.066
4,R_1nVYSEciL6sPzAO,33,j,2,0,2622,Remove Christopher Columbus statues,Mandatory trigger warnings,-1,-1,-2,0,3,-0.7214723751188964,-3,0,2,-1.202453958531494,2,3,1,-1,0,1,0,-1,1,1,1,2.622
4,R_1nVYSEciL6sPzAO,34,f,1,1,1500,Abolishing private prisons,U.S. drone strikes in Afghanistan,1,1,3,7,3,1.6834355419440914,-1,0,2,-0.24049079170629878,3,-1,4,4,7,4,7,4,-4,4,0,1.5
4,R_1nVYSEciL6sPzAO,35,j,2,0,1570,Defund Planned Parenthood,Abolishing private prisons,1,1,2,7,3,1.202453958531494,3,7,3,1.6834355419440914,2,3,1,1,0,1,0,-1,1,-1,1,1.57
4,R_1nVYSEciL6sPzAO,36,f,1,1,2450,Expel students with white nationlist views,Defund Planned Parenthood,-1,1,-3,8,1,-1.202453958531494,2,7,3,1.202453958531494,3,2,1,-5,1,1,1,1,-1,-5,0,2.45
4,R_1nVYSEciL6sPzAO,37,f,1,1,2232,Affirmative action,Climate change legislation,-1,1,-3,4,4,-1.202453958531494,-3,0,4,-1.202453958531494,3,-3,6,0,4,6,4,6,-6,0,0,2.232
4,R_1nVYSEciL6sPzAO,38,j,2,0,2700,U.S. drone strikes in Afghanistan,Lift COVID lockdowns,-1,1,-1,0,2,-0.24049079170629878,3,8,4,1.6834355419440914,1,3,2,4,8,2,8,-2,2,-4,1,2.7
4,R_1nVYSEciL6sPzAO,39,j,2,0,2573,Bathrooms restricted based on biological sex,Abolishing private prisons,1,1,3,4,3,1.6834355419440914,3,7,3,1.6834355419440914,3,3,0,0,3,0,3,0,0,0,1,2.573
4,R_1nVYSEciL6sPzAO,40,f,1,1,2036,Raise the minimum wage,Black Lives Matter,1,1,-2,0,4,-0.7214723751188964,-3,4,3,-1.202453958531494,-2,-3,1,1,-4,1,4,1,-1,1,0,2.036
4,R_1nVYSEciL6sPzAO,41,f,1,1,1230,Abolishing private prisons,Remove Christopher Columbus statues,1,1,3,7,3,1.6834355419440914,-2,0,3,-0.7214723751188964,3,-2,5,5,7,5,7,5,-5,5,0,1.23
4,R_1nVYSEciL6sPzAO,42,f,1,1,2658,Expel students with white nationlist views,Abolishing private prisons,-1,1,-3,8,1,-1.202453958531494,3,7,3,1.6834355419440914,3,3,0,-6,1,0,1,0,0,-6,0,2.658
4,R_1nVYSEciL6sPzAO,43,j,2,0,2032,Cuts to National Parks budget,Black Lives Matter,1,-1,0,0,1,0.24049079170629878,-3,4,3,-1.202453958531494,0,3,3,-3,4,3,4,-3,3,3,1,2.032
4,R_1nVYSEciL6sPzAO,44,f,1,1,2464,Black Lives Matter,Lift COVID lockdowns,-1,-1,-3,4,3,-1.202453958531494,3,8,4,1.6834355419440914,3,-3,6,-6,-4,6,4,6,-6,-6,0,2.464
4,R_1nVYSEciL6sPzAO,45,f,1,1,2222,Bathrooms restricted based on biological sex,Build southern border wall,1,-1,3,4,3,1.6834355419440914,2,0,4,1.202453958531494,3,-2,5,1,4,5,4,5,-5,1,0,2.222
4,R_1nVYSEciL6sPzAO,46,j,2,0,2015,Mandatory vaccinations,Allow alt-right speakers on campus,1,1,-3,8,4,-1.202453958531494,3,8,3,1.6834355419440914,-3,3,6,6,0,6,0,-6,6,-6,1,2.015
4,R_1nVYSEciL6sPzAO,47,j,2,0,1846,U.S. drone strikes in Afghanistan,Affirmative action,1,-1,-1,0,2,-0.24049079170629878,-3,4,4,-1.202453958531494,-1,3,4,-2,4,4,4,-4,4,2,1,1.846
4,R_1nVYSEciL6sPzAO,48,f,1,1,2095,Expel students with white nationlist views,Black Lives Matter,1,1,-3,8,1,-1.202453958531494,-3,4,3,-1.202453958531494,-3,-3,0,0,4,0,4,0,0,0,0,2.095
4,R_1nVYSEciL6sPzAO,49,f,1,1,2317,Abolishing private prisons,Remove public Confederate memorials,1,1,3,7,3,1.6834355419440914,-3,0,4,-1.202453958531494,3,-3,6,6,7,6,7,6,-6,6,0,2.317
4,R_1nVYSEciL6sPzAO,50,f,1,1,1562,Black Lives Matter,Abolishing private prisons,-1,-1,-3,4,3,-1.202453958531494,3,7,3,1.6834355419440914,3,-3,6,-6,-3,6,3,6,-6,-6,0,1.562
4,R_1nVYSEciL6sPzAO,51,f,1,1,6425,Bathrooms restricted based on biological sex,Ban on research with animals,-1,-1,3,4,3,1.6834355419440914,1,4,3,0.7214723751188964,-3,-1,-2,2,0,2,0,-2,2,2,0,6.425
4,R_1nVYSEciL6sPzAO,52,f,1,1,2158,Allow alt-right speakers on campus,"Boycott, Divest, and Sanction Israel",1,1,3,8,3,1.6834355419440914,0,0,2,0.24049079170629878,3,0,3,3,8,3,8,3,-3,3,0,2.158
4,R_1nVYSEciL6sPzAO,53,j,2,0,1850,Bathrooms restricted based on biological sex,Stop police brutality,-1,1,3,4,3,1.6834355419440914,2,4,3,1.202453958531494,-3,2,5,-1,0,5,0,-5,5,1,1,1.85
4,R_1nVYSEciL6sPzAO,54,j,2,0,2283,Lift COVID lockdowns,Climate change legislation,1,-1,3,8,4,1.6834355419440914,-3,0,4,-1.202453958531494,3,3,0,-6,-8,0,8,0,0,6,1,2.283
4,R_1nVYSEciL6sPzAO,55,f,1,1,1855,Allow alt-right speakers on campus,Ban on research with animals,1,-1,3,8,3,1.6834355419440914,1,4,3,0.7214723751188964,3,-1,4,2,4,4,4,4,-4,2,0,1.855
4,R_1nVYSEciL6sPzAO,56,f,1,1,2005,Lift COVID lockdowns,Defund Planned Parenthood,1,-1,3,8,4,1.6834355419440914,2,7,3,1.202453958531494,3,-2,5,1,1,5,1,5,-5,1,0,2.005
4,R_1nVYSEciL6sPzAO,57,f,1,1,1482,Lift COVID lockdowns,U.S. drone strikes in Afghanistan,1,1,3,8,4,1.6834355419440914,-1,0,2,-0.24049079170629878,3,-1,4,4,8,4,8,4,-4,4,0,1.482
4,R_1nVYSEciL6sPzAO,58,f,1,1,2448,Climate change legislation,Remove public Confederate memorials,-1,1,-3,0,4,-1.202453958531494,-3,0,4,-1.202453958531494,3,-3,6,0,0,6,0,6,-6,0,0,2.448
4,R_1nVYSEciL6sPzAO,59,f,1,1,3903,Expel students with white nationlist views,Ban on research with animals,-1,1,-3,8,1,-1.202453958531494,1,4,3,0.7214723751188964,3,1,2,-4,4,2,4,2,-2,-4,0,3.903
4,R_1nVYSEciL6sPzAO,60,f,1,1,2185,Increased Gun regulations,Affirmative action,-1,1,-3,0,4,-1.202453958531494,-3,4,4,-1.202453958531494,3,-3,6,0,-4,6,4,6,-6,0,0,2.185
4,R_1nVYSEciL6sPzAO,61,f,1,1,2809,Abolishing private prisons,Climate change legislation,-1,1,3,7,3,1.6834355419440914,-3,0,4,-1.202453958531494,-3,-3,0,6,7,0,7,0,0,6,0,2.809
4,R_1nVYSEciL6sPzAO,62,j,2,0,2920,Black Lives Matter,Ban on research with animals,1,1,-3,4,3,-1.202453958531494,1,4,3,0.7214723751188964,-3,1,4,4,0,4,0,-4,4,-4,1,2.92
4,R_1nVYSEciL6sPzAO,63,f,1,1,4478,Lift COVID lockdowns,Increased Gun regulations,-1,1,3,8,4,1.6834355419440914,-3,0,4,-1.202453958531494,-3,-3,0,6,8,0,8,0,0,6,0,4.478
4,R_1nVYSEciL6sPzAO,64,f,1,1,1877,Climate change legislation,Stop police brutality,-1,1,-3,0,4,-1.202453958531494,2,4,3,1.202453958531494,3,2,1,-5,-4,1,4,1,-1,-5,0,1.877
4,R_1nVYSEciL6sPzAO,65,j,2,0,1960,Affirmative action,U.S. drone strikes in Afghanistan,1,1,-3,4,4,-1.202453958531494,-1,0,2,-0.24049079170629878,-3,-1,2,2,-4,2,4,-2,2,-2,1,1.96
4,R_1nVYSEciL6sPzAO,66,j,2,0,2614,Lift COVID lockdowns,Stop police brutality,-1,1,3,8,4,1.6834355419440914,2,4,3,1.202453958531494,-3,2,5,-1,-4,5,4,-5,5,1,1,2.614
4,R_1nVYSEciL6sPzAO,67,f,1,1,3173,Abolishing private prisons,Defund Planned Parenthood,-1,-1,3,7,3,1.6834355419440914,2,7,3,1.202453958531494,-3,-2,-1,1,0,1,0,-1,1,1,0,3.173
4,R_1nVYSEciL6sPzAO,68,f,1,1,1693,Ban on research with animals,Abolishing private prisons,1,-1,1,4,3,0.7214723751188964,3,7,3,1.6834355419440914,1,-3,4,-2,-3,4,3,4,-4,-2,0,1.693
4,R_1nVYSEciL6sPzAO,69,j,2,0,3361,Affirmative action,Defund Planned Parenthood,1,-1,-3,4,4,-1.202453958531494,2,7,3,1.202453958531494,-3,-2,1,5,3,1,3,-1,1,-5,1,3.361
4,R_1nVYSEciL6sPzAO,70,j,2,0,2454,Affirmative action,Remove public Confederate memorials,1,1,-3,4,4,-1.202453958531494,-3,0,4,-1.202453958531494,-3,-3,0,0,-4,0,4,0,0,0,1,2.454
4,R_1nVYSEciL6sPzAO,71,f,1,1,2040,Abolishing private prisons,Allow alt-right speakers on campus,1,-1,3,7,3,1.6834355419440914,3,8,3,1.6834355419440914,3,-3,6,0,-1,6,1,6,-6,0,0,2.04
4,R_1nVYSEciL6sPzAO,72,j,2,0,2232,Expel students with white nationlist views,Defund Planned Parenthood,1,1,-3,8,1,-1.202453958531494,2,7,3,1.202453958531494,-3,2,5,5,-1,5,1,-5,5,-5,1,2.232
4,R_1nVYSEciL6sPzAO,73,j,2,0,1747,Affirmative action,Abolishing private prisons,1,-1,-3,4,4,-1.202453958531494,3,7,3,1.6834355419440914,-3,-3,0,6,3,0,3,0,0,-6,1,1.747
4,R_1nVYSEciL6sPzAO,74,f,1,1,2841,Stop police brutality,Abolishing private prisons,-1,-1,2,4,3,1.202453958531494,3,7,3,1.6834355419440914,-2,-3,1,-1,-3,1,3,1,-1,-1,0,2.841
4,R_1nVYSEciL6sPzAO,75,f,1,1,1461,Allow alt-right speakers on campus,Bathrooms restricted based on biological sex,1,-1,3,8,3,1.6834355419440914,3,4,3,1.6834355419440914,3,-3,6,0,4,6,4,6,-6,0,0,1.461
4,R_1nVYSEciL6sPzAO,76,j,2,0,1760,Stop police brutality,Black Lives Matter,-1,-1,2,4,3,1.202453958531494,-3,4,3,-1.202453958531494,-2,3,5,-5,0,5,0,-5,5,5,1,1.76
4,R_1nVYSEciL6sPzAO,77,f,1,1,3285,Remove public Confederate memorials,Defund Planned Parenthood,-1,-1,-3,0,4,-1.202453958531494,2,7,3,1.202453958531494,3,-2,5,-5,-7,5,7,5,-5,-5,0,3.285
4,R_1nVYSEciL6sPzAO,78,j,2,0,4056,Allow alt-right speakers on campus,U.S. drone strikes in Afghanistan,-1,1,3,8,3,1.6834355419440914,-1,0,2,-0.24049079170629878,-3,-1,2,-4,-8,2,8,-2,2,4,1,4.056
4,R_1nVYSEciL6sPzAO,79,f,1,1,3025,Abolishing private prisons,Ban on research with animals,-1,-1,3,7,3,1.6834355419440914,1,4,3,0.7214723751188964,-3,-1,-2,2,3,2,3,-2,2,2,0,3.025
4,R_1nVYSEciL6sPzAO,80,j,2,0,1740,Abolishing private prisons,Abolishing private prisons,-1,1,3,7,3,1.6834355419440914,3,7,3,1.6834355419440914,-3,3,6,0,0,6,0,-6,6,0,1,1.74
4,R_1nVYSEciL6sPzAO,81,f,1,1,2118,Abolishing private prisons,Defund Planned Parenthood,1,-1,3,7,3,1.6834355419440914,2,7,3,1.202453958531494,3,-2,5,1,0,5,0,5,-5,1,0,2.118
4,R_1nVYSEciL6sPzAO,82,j,2,0,3304,Bathrooms restricted based on biological sex,Increased Gun regulations,1,-1,3,4,3,1.6834355419440914,-3,0,4,-1.202453958531494,3,3,0,-6,-4,0,4,0,0,6,1,3.304
4,R_1nVYSEciL6sPzAO,83,f,1,1,1983,Climate change legislation,Raise the minimum wage,-1,1,-3,0,4,-1.202453958531494,-2,0,4,-0.7214723751188964,3,-2,5,-1,0,5,0,5,-5,-1,0,1.983
4,R_1nVYSEciL6sPzAO,84,f,1,1,1846,Stop police brutality,Bathrooms restricted based on biological sex,1,1,2,4,3,1.202453958531494,3,4,3,1.6834355419440914,2,3,-1,-1,0,1,0,-1,1,-1,0,1.846
4,R_1nVYSEciL6sPzAO,85,f,1,1,1578,Lift COVID lockdowns,Build southern border wall,1,-1,3,8,4,1.6834355419440914,2,0,4,1.202453958531494,3,-2,5,1,8,5,8,5,-5,1,0,1.578
4,R_1nVYSEciL6sPzAO,86,f,1,1,2447,Ban on research with animals,Allow alt-right speakers on campus,1,-1,1,4,3,0.7214723751188964,3,8,3,1.6834355419440914,1,-3,4,-2,-4,4,4,4,-4,-2,0,2.447
4,R_1nVYSEciL6sPzAO,87,j,2,0,2138,Ban on research with animals,Abolishing private prisons,1,1,1,4,3,0.7214723751188964,3,7,3,1.6834355419440914,1,3,2,2,3,2,3,-2,2,-2,1,2.138
4,R_1nVYSEciL6sPzAO,88,j,2,0,2141,Ban on research with animals,Affirmative action,-1,-1,1,4,3,0.7214723751188964,-3,4,4,-1.202453958531494,-1,3,4,-4,0,4,0,-4,4,4,1,2.141
4,R_1nVYSEciL6sPzAO,89,j,2,0,2585,Expel students with white nationlist views,Increased Gun regulations,1,-1,-3,8,1,-1.202453958531494,-3,0,4,-1.202453958531494,-3,3,6,0,-8,6,8,-6,6,0,1,2.585
4,R_1nVYSEciL6sPzAO,90,j,2,0,2269,Stop police brutality,Mandatory vaccinations,1,-1,2,4,3,1.202453958531494,-3,8,4,-1.202453958531494,2,3,1,-5,4,1,4,-1,1,5,1,2.269
4,R_1nVYSEciL6sPzAO,91,f,1,1,2987,Lift COVID lockdowns,Defund Planned Parenthood,-1,-1,3,8,4,1.6834355419440914,2,7,3,1.202453958531494,-3,-2,-1,1,1,1,1,-1,1,1,0,2.987
4,R_1nVYSEciL6sPzAO,92,f,1,1,3189,Abolishing fraternities,Abolishing private prisons,1,-1,0,0,1,0.24049079170629878,3,7,3,1.6834355419440914,0,-3,3,-3,-7,3,7,3,-3,-3,0,3.189
4,R_1nVYSEciL6sPzAO,93,f,1,1,3436,Abolishing private prisons,U.S. drone strikes in Afghanistan,1,-1,3,7,3,1.6834355419440914,-1,0,2,-0.24049079170629878,3,1,2,4,7,2,7,2,-2,4,0,3.436
4,R_1nVYSEciL6sPzAO,94,f,1,1,2500,Allow alt-right speakers on campus,Mandatory trigger warnings,1,1,3,8,3,1.6834355419440914,-3,0,2,-1.202453958531494,3,-3,6,6,8,6,8,6,-6,6,0,2.5
4,R_1nVYSEciL6sPzAO,95,j,2,0,1590,Abolishing private prisons,Defund Planned Parenthood,-1,1,3,7,3,1.6834355419440914,2,7,3,1.202453958531494,-3,2,5,-1,0,5,0,-5,5,1,1,1.59
4,R_1nVYSEciL6sPzAO,96,f,1,1,1938,Mandatory vaccinations,Stop police brutality,-1,-1,-3,8,4,-1.202453958531494,2,4,3,1.202453958531494,3,-2,5,-5,4,5,4,5,-5,-5,0,1.938
4,R_1nVYSEciL6sPzAO,97,j,2,0,1476,Black Lives Matter,Build southern border wall,1,1,-3,4,3,-1.202453958531494,2,0,4,1.202453958531494,-3,2,5,5,-4,5,4,-5,5,-5,1,1.476
4,R_1nVYSEciL6sPzAO,98,j,2,0,1802,Mandatory vaccinations,Remove Christopher Columbus statues,1,1,-3,8,4,-1.202453958531494,-2,0,3,-0.7214723751188964,-3,-2,1,1,-8,1,8,-1,1,-1,1,1.802
4,R_1nVYSEciL6sPzAO,99,f,1,1,2707,Ban on research with animals,Lift COVID lockdowns,-1,-1,1,4,3,0.7214723751188964,3,8,4,1.6834355419440914,-1,-3,2,-2,-4,2,4,2,-2,-2,0,2.707
4,R_1nVYSEciL6sPzAO,100,j,2,0,2695,Mandatory vaccinations,Ban on ethnic Halloween costumes,-1,-1,-3,8,4,-1.202453958531494,-2,0,1,-0.7214723751188964,3,2,-1,1,-8,1,8,1,-1,-1,1,2.695
